"date","subject_to_limit","ceiling","dist_to_ceiling","rate","change","deposits","withdrawals","z_change","error","balance","rate"
2005-08-05,7821225,8184000,362775,3.49,-1652,6404,8056,-0.188613924172578,4623.85714339659,9553,3.49
2005-08-08,7824043,8184000,359957,3.5,3362,9867,6505,0.339405217241702,4060.48494748228,12915,3.5
2005-08-09,7825122,8184000,358878,3.47,-3063,3928,6991,-0.323895910930302,4341.59759592257,9852,3.47
2005-08-10,7821713,8184000,362287,3.48,-1624,9204,10829,-0.148896274686604,4235.82643498309,8228,3.48
2005-08-11,7824323,8184000,359677,3.51,-1588,68533,70121,-0.0673647664853975,4617.97445049199,6640,3.51
2005-08-12,7823599,8184000,360401,3.55,-946,8009,8955,0.0064822911304018,4415.02839220409,5694,3.55
2005-08-15,7852219,8184000,331781,3.61,2891,63613,60722,0.496509096676241,4213.29060961989,8585,3.61
2005-08-16,7857784,8184000,326216,3.46,4296,11030,6734,0.685282093929498,3871.78552663829,12881,3.46
2005-08-17,7857792,8184000,326208,3.57,-570,9482,10052,0.0930905968103461,4029.55703451936,12311,3.57
2005-08-18,7866527,8184000,317473,3.5,2129,72357,70228,0.449911491477488,3996.80128888805,14440,3.5
2005-08-19,7866998,8184000,317002,3.54,1841,8702,6861,0.369856242396215,4022.02015921242,16281,3.54
2005-08-22,7867914,8184000,316086,3.51,4171,9819,5648,0.689722973720586,4434.90281304011,20452,3.51
2005-08-23,7873589,8184000,310411,3.49,-2647,3291,5938,-0.270814468791492,3907.52920187323,17805,3.49
2005-08-24,7870988,8184000,313012,3.5,-3436,7621,11057,-0.383610135435244,4274.31269096667,14369,3.5
2005-08-25,7873400,8184000,310600,3.55,-540,70599,71139,0.0602893211656038,4189.67522967577,13829,3.55
2005-08-26,7872969,8184000,311031,3.54,-2689,5984,8674,-0.347435988847734,4473.63882570522,11140,3.54
2005-08-29,7871565,8184000,312435,3.54,3517,11013,7497,0.683180764318252,4615.50706315135,14657,3.54
2005-08-30,7871193,8184000,312807,3.52,-4232,3446,7678,-0.835670730948141,4401.56339351632,10425,3.52
2005-08-31,7868395,8184000,315605,3.63,-1860,36934,38794,-0.368946071737686,3892.35923673262,8565,3.63
2005-09-01,7868454,8184000,315546,3.57,-2237,94613,96850,-0.444383157382096,4588.34388423536,6328,3.57
2005-09-02,7879319,8184000,304681,3.49,900,27824,26924,0.173995283701773,4800.03435925203,7228,3.49
2005-09-06,7881521,8184000,302479,3.57,826,9812,8986,0.164623029113925,4081.07227817427,8054,3.57
2005-09-07,7886918,8184000,297082,3.48,-2143,6921,9064,-0.418507798800444,4416.8624836196,5911,3.48
2005-09-08,7888666,8184000,295334,3.49,4178,78921,74742,0.805143687141418,4295.9797060648,10089,3.49
2005-09-09,7889293,8184000,294707,3.49,-2988,6629,9617,-0.579481737528067,5039.38103050711,7101,3.49
2005-09-12,7889178,8184000,294822,3.5,3613,11087,7474,0.743871723682293,4118.89420319858,10714,3.5
2005-09-13,7893418,8184000,290582,3.45,487,7933,7445,0.164211224090077,3803.12669475383,11201,3.45
2005-09-14,7882113,8184000,301887,3.54,-3425,14777,18202,-0.654478891349316,4114.40622603762,7776,3.54
2005-09-15,7856793,8184000,327207,3.67,32827,150290,117463,4.55750871744564,4600.23649564596,40603,3.67
2005-09-16,7858868,8184000,325132,3.62,8622,15202,6580,1.12077544053488,4586.60518992577,49225,3.62
2005-09-19,7864170,8184000,319830,3.62,6724,13173,6449,0.831411458331003,4297.58330861014,55949,3.62
2005-09-20,7868850,8184000,315150,3.67,14660,20900,6241,1.81479168836677,3721.072566404,70609,3.67
2005-09-21,7867516,8184000,316484,3.72,2316,13416,11100,0.162734857528256,4056.896578667,72925,3.72
2005-09-22,7859876,8184000,324124,3.77,-12832,62420,75251,-1.74751791385878,3970.76585502052,60093,3.77
2005-09-23,7859543,8184000,324457,3.76,790,9282,8492,0.00873887402209318,3908.29451894626,60883,3.76
2005-09-26,7861188,8184000,322812,3.83,2680,10840,8161,0.2754025772672,4418.96629440768,63563,3.83
2005-09-27,7865540,8184000,318460,3.73,-3078,4777,7855,-0.533883659978582,4630.15341401358,60485,3.73
2005-09-28,7861083,8184000,322917,3.76,-2943,8779,11722,-0.505211511528999,3995.77860104529,57542,3.76
2005-09-29,7852742,8184000,331258,3.82,-7273,66508,73780,-1.2136874410408,4276.86275503398,50269,3.82
2005-09-30,7871040,8184000,312960,3.93,-14590,36966,51556,-2.0899917082557,4306.71565245619,35679,3.93
2005-10-03,7909115,8184000,274885,3.87,-20937,20336,41273,-2.62428345158513,4238.91698760164,14742,3.87
2005-10-04,7916643,8184000,267357,3.75,-5212,4405,9617,-0.636662729781548,3938.31806014409,9530,3.75
2005-10-05,7917717,8184000,266283,3.75,2091,10092,8001,0.254388237289935,3953.61518739495,11621,3.75
2005-10-06,7932417,8184000,251583,3.76,7495,73419,65924,0.888830806360539,4169.49834246013,19116,3.76
2005-10-07,7928868,8184000,255132,3.73,-3929,6238,10167,-0.50840838586492,4823.75987583156,15187,3.73
2005-10-11,7929695,8184000,254305,3.72,211,10913,10702,-0.00387913183395934,3960.37666638952,15398,3.72
2005-10-12,7929299,8184000,254701,3.36,-7623,5390,13013,-0.924040459225359,4183.30694888284,7775,3.36
2005-10-13,7933506,8184000,250494,3.75,2190,67696,65506,0.275758086257238,4223.48530263659,9965,3.75
2005-10-14,7924811,8184000,259189,3.77,-781,8878,9659,-0.0856424656756234,4523.89309551879,9184,3.77
2005-10-17,7935062,8184000,248938,3.82,20149,43491,23341,2.24641658906885,4058.17730451993,29333,3.82
2005-10-18,7942391,8184000,241609,3.71,-2190,5146,7336,-0.279420554970024,4621.68088667467,27143,3.71
2005-10-19,7938428,8184000,245572,3.71,-293,10767,11060,-0.0515473770052164,4388.68221679356,26850,3.71
2005-10-20,7947571,8184000,236429,3.77,4049,67447,63398,0.423107393991131,4422.59954251932,30899,3.77
2005-10-21,7947158,8184000,236842,3.76,-1536,7122,8657,-0.217630081023164,4521.36069243664,29363,3.76
2005-10-24,7948359,8184000,235641,3.76,1199,10155,8956,0.0889159046450352,4263.90138840007,30562,3.76
2005-10-25,7952122,8184000,231878,3.74,-3272,4561,7833,-0.418378832306168,4607.4819824123,27290,3.74
2005-10-26,7949614,8184000,234386,3.75,-2674,8978,11652,-0.332762078130037,3756.25277423768,24616,3.75
2005-10-27,7963796,8184000,220204,3.85,9505,74517,65013,1.00453247197452,4043.18381254965,34121,3.85
2005-10-28,7967916,8184000,216084,3.9,7284,15216,7932,0.724127737976652,3744.39469921269,41405,3.9
2005-10-31,7964782,8184000,219218,4.02,-695,40567,41262,-0.174374682971016,3937.73348876882,40710,4.02
2005-11-01,7952976,8184000,231024,3.99,-16594,13474,30068,-1.82336528710727,4055.89083006395,24116,3.99
2005-11-02,7958951,8184000,225049,3.99,3338,10676,7338,0.305344763462385,3954.30773023507,27454,3.99
2005-11-03,7964964,8184000,219036,4.01,-12758,71760,84518,-1.35633797968725,5038.66765544856,14696,4.01
2005-11-04,7965303,8184000,218697,4,-2254,8657,10910,-0.24208068759884,4853.16882725844,12442,4
2005-11-07,7968730,8184000,215270,3.99,-56,9835,9891,-0.0197171085012425,4918.01031995083,12386,3.99
2005-11-08,7973900,8184000,210100,3.95,-4047,3910,7957,-0.417708910378511,3928.39587309048,8339,3.95
2005-11-09,7971942,8184000,212058,4.02,928,11849,10920,0.102264273407953,4128.40291759416,9267,4.02
2005-11-10,7987344,8184000,196656,3.98,8726,78416,69690,0.87959544647243,4671.97290843417,17993,3.98
2005-11-14,7988695,8184000,195305,4.03,6069,14747,8678,0.798286440500335,4093.32811413891,24062,4.03
2005-11-15,8002607,8184000,181393,3.97,-19577,62461,82038,-2.16401429982675,4345.28595466142,4485,3.97
2005-11-16,8000153,8184000,183847,3.96,2746,15094,12349,0.468614969574526,3937.94947003786,7231,3.96
2005-11-17,8019228,8184000,164772,3.98,10746,78661,67915,1.45472511430861,4590.14897015924,17977,3.98
2005-11-18,8018802,8184000,165198,4,-1479,8299,9778,-0.00826126349322016,4507.55209004227,16498,4
2005-11-21,8021115,8184000,162885,4.03,1438,10137,8699,0.308766282917657,4274.6927162375,17936,4.03
2005-11-22,8025362,8184000,158638,3.99,-5377,3223,8600,-0.515103097450351,4193.61857639506,12559,3.99
2005-11-23,8021374,8184000,162626,4.01,-7853,8776,16629,-0.7844756286376,3945.94923206869,4706,4.01
2005-11-25,8031809,8184000,152191,4.03,7384,82396,75011,1.04177879569273,4988.88201706141,12090,4.03
2005-11-28,8035033,8184000,148967,4.01,2141,7437,5296,0.390240206944979,4298.60360456816,14231,4.01
2005-11-29,8033980,8184000,150020,3.99,-3712,5109,8821,-0.331024734515032,4286.32606169233,10519,3.99
2005-11-30,8028919,8184000,155081,4.03,-4531,37716,42246,-0.477536341287149,4111.22419029383,5988,4.03
2005-12-01,8043836,8184000,140164,4.03,10084,105626,95541,1.35674686100136,4130.37569796613,16072,4.03
2005-12-02,8054284,8184000,129716,4,-4228,26232,30460,-0.579817015622396,4488.80466748745,11844,4
2005-12-05,8055788,8184000,128212,4.02,-1407,9606,11013,-0.186443799993256,4211.09396967446,10437,4.02
2005-12-06,8059111,8184000,124889,3.97,-5156,3784,8940,-0.656411358674332,4433.09465191723,5281,3.97
2005-12-07,8058162,8184000,125838,3.98,2499,9689,7190,0.366801022136592,4009.02523589756,7780,3.98
2005-12-08,8066866,8184000,117134,4.09,2585,80112,77526,0.369790390804316,4229.07188474601,10365,4.09
2005-12-09,8067234,8184000,116766,4.16,-251,6279,6530,-0.0428080926932477,4800.08080380069,10114,4.16
2005-12-12,8068250,8184000,115750,4.24,5233,11391,6158,0.701466902731631,4235.20675485261,15347,4.24
2005-12-13,8072453,8184000,111547,4.23,-6862,4310,11172,-0.931096859550821,4543.28860509723,8485,4.23
2005-12-14,8068483,8184000,115517,4.26,4050,15366,11316,0.674884047819329,4090.23644094778,12535,4.26
2005-12-15,8035138,8184000,148862,4.29,23145,157360,134215,3.02111303127677,4405.05467093977,35680,4.29
2005-12-16,8036859,8184000,147141,4.25,8119,17101,8982,1.00043858396188,4125.50704416179,43799,4.25
2005-12-19,8039319,8184000,144681,4.25,4272,12559,8288,0.499397200229587,4320.44212271317,48071,4.25
2005-12-20,8043546,8184000,140454,4.3,-1746,5008,6753,-0.281966629426064,4402.4860822004,46325,4.3
2005-12-21,8036513,8184000,147487,4.08,550,12982,12432,0.0184759666186998,3795.48112724877,46875,4.08
2005-12-22,8030710,8184000,153290,4.25,-11499,67046,78546,-1.48056939309321,4227.17048859903,35376,4.25
2005-12-23,8033173,8184000,150827,4.21,8035,9850,1814,0.94751384414433,4375.22494188167,43411,4.21
2005-12-27,8036635,8184000,147365,4.26,5552,12354,6802,0.656362146273548,3934.04374012368,48963,4.26
2005-12-28,8036221,8184000,147779,4.19,-6266,6619,12885,-0.799287475218697,4070.50839488843,42697,4.19
2005-12-29,8023212,8184000,160788,4.18,-4170,70450,74621,-0.520463837830757,4490.14637050636,38527,4.18
2005-12-30,8107030,8184000,76970,4.09,-1903,14733,16636,-0.297525191044404,4320.30267559232,36624,4.09
2006-01-03,8090781,8184000,93219,4.34,-18335,68792,87127,-2.26607135822183,4208.32375821636,18289,4.34
2006-01-04,8102865,8184000,81135,4.22,103,9768,9664,0.00137175360530033,4248.4769449283,18392,4.22
2006-01-05,8096618,8184000,87382,4.24,-5441,67400,72841,-0.702033380957499,4514.40855053141,12951,4.24
2006-01-06,8097912,8184000,86088,4.22,1224,8232,7009,0.151756922041901,4477.467819937,14175,4.22
2006-01-09,8096980,8184000,87020,4.25,4099,11002,6903,0.495730695292675,4092.87847587171,18274,4.25
2006-01-10,8102477,8184000,81523,4.24,-1370,6465,7836,-0.200867562148453,4681.97088604551,16904,4.24
2006-01-11,8098870,8184000,85130,4.24,-2307,9798,12105,-0.290275438777152,3992.33125862214,14597,4.24
2006-01-12,8095350,8184000,88650,4.28,-8345,62700,71046,-1.02631844384641,4619.44072647294,6252,4.28
2006-01-13,8095045,8184000,88955,4.3,768,12321,11554,0.10001610972507,4226.08335720718,7020,4.3
2006-01-17,8107324,8184000,76676,4.32,25198,53332,28134,3.04036172324845,4142.84145980885,32218,4.32
2006-01-18,8110758,8184000,73242,4.24,5907,19697,13790,0.678609285838988,4211.72743393703,38125,4.24
2006-01-19,8113120,8184000,70880,4.23,3082,71587,68505,0.309354952168648,4416.62628193576,41207,4.23
2006-01-20,8112022,8184000,71978,4.24,2930,10433,7504,0.285324909597755,4185.90497042498,44137,4.24
2006-01-23,8110869,8184000,73131,4.26,9443,16617,7174,1.04826364325628,4341.34891799516,53580,4.26
2006-01-24,8122020,8184000,61980,4.28,6547,13120,6573,0.649732205793607,4221.39707512489,60127,4.28
2006-01-25,8118718,8184000,65282,4.36,211,11707,11496,-0.126200375854909,3489.24102665085,60338,4.36
2006-01-26,8126614,8184000,57386,4.37,1916,71765,69849,0.0907293166563807,4588.51673582222,62254,4.37
2006-01-27,8126529,8184000,57471,4.42,-4926,9603,14529,-0.770994035293305,4548.7195382109,57328,4.42
2006-01-30,8123189,8184000,60811,4.48,5284,13301,8017,0.49105418060843,4433.96606691342,62612,4.48
2006-01-31,8132290,8184000,51710,4.47,6239,47773,41533,0.631335161832234,4433.63971614064,68851,4.47
2006-02-01,8119466,8184000,64534,4.47,-13520,20784,34304,-1.80457623741501,4366.7307490754,55331,4.47
2006-02-02,8134649,8184000,49351,4.48,10399,77904,67506,1.09750968198261,4196.01473084027,65730,4.48
2006-02-03,8131669,8184000,52331,4.51,-28984,8713,37697,-3.14370126748299,4779.60491759036,36746,4.51
2006-02-06,8133183,8184000,50817,4.51,1879,10556,8678,0.117017999377338,4395.56655313236,38625,4.51
2006-02-07,8137311,8184000,46689,4.47,-5328,4122,9450,-0.620454192647721,4837.06646332619,33297,4.47
2006-02-08,8133848,8184000,50152,4.48,-3149,9222,12372,-0.383036776021821,4297.81925284891,30148,4.48
2006-02-09,8140742,8184000,43258,4.52,4829,71049,66220,0.455517285610747,4727.30380687974,34977,4.52
2006-02-10,8140371,8184000,43629,4.51,-23024,7647,30672,-2.27355987924012,4708.08424558143,11953,4.51
2006-02-13,8140849,8184000,43151,4.44,3612,11456,7844,0.348027317783942,4034.06410804015,15565,4.44
2006-02-14,8145171,8184000,38829,4.45,-1844,5554,7399,-0.137048521867052,4484.84163856606,13721,4.45
2006-02-15,8173950,8184000,10050,4.5,3863,65233,61370,0.482065997858681,4017.30429517108,17584,4.5
2006-02-16,8183975,8184000,25,4.48,15311,81317,66006,1.62103481633944,4147.88626022674,32895,4.48
2006-02-17,8183975,8184000,25,4.48,-21189,6876,28064,-1.98810052826247,4198.70734860223,11706,4.48
2006-02-21,8183975,8184000,25,4.54,5631,13214,7584,0.620074508661867,4320.5545583945,17337,4.54
2006-02-22,8183975,8184000,25,4.49,-8110,6058,14168,-0.731385418022356,4122.72430993321,9227,4.49
2006-02-23,8183975,8184000,25,4.47,11796,81941,70146,1.20030737479401,4493.50660000469,21023,4.47
2006-02-24,8183975,8184000,25,4.48,-15642,7632,23274,-1.38407262385289,3970.45375240664,5381,4.48
2006-02-27,8183975,8184000,25,4.52,5009,13988,8979,0.552757060555389,4099.92908378468,10390,4.52
2006-02-28,8183975,8184000,25,4.52,7717,52432,44715,0.776674040130652,4134.63508226446,18107,4.52
2006-03-01,8183975,8184000,25,4.52,-12582,22210,34793,-1.09682426918811,3957.72345537259,5525,4.52
2006-03-02,8183975,8184000,25,4.5,6496,81765,75269,0.637542238883932,4757.98803509041,12021,4.5
2006-03-03,8183975,8184000,25,4.51,-4330,34025,38355,-0.388545090531065,4685.55112062266,7691,4.51
2006-03-06,8183975,8184000,25,4.51,3441,12114,8673,0.334042547061601,3953.49014906198,11132,4.51
2006-03-07,8183975,8184000,25,4.51,-4417,4403,8820,-0.404533860160757,4904.36278727485,6715,4.51
2006-03-08,8183975,8184000,25,4.51,3988,16355,12367,0.399488310650433,3884.27933460074,10703,4.51
2006-03-09,8183975,8184000,25,4.51,6371,76836,70465,0.606029932216168,4442.01068550704,17074,4.51
2006-03-10,8183975,8184000,25,4.51,-10077,8112,18190,-0.930917578562443,4177.55474919715,6997,4.51
2006-03-13,8183975,8184000,25,4.52,6487,14994,8507,0.595624040730522,4198.6137669814,13484,4.52
2006-03-14,8183975,8184000,25,4.51,-2968,12519,15487,-0.288280331955019,4445.88526608665,10516,4.51
2006-03-15,8183975,8184000,25,4.47,4928,50468,45541,0.54433925249012,4463.61558862497,15444,4.47
2006-03-16,8183975,8184000,25,4.55,16393,88620,72227,1.63349183597005,4648.7696989941,31837,4.55
2006-03-17,8183975,8184000,25,4.6,-7852,6678,14530,-0.728343476507937,3919.65547593153,23985,4.6
2006-03-20,8261691,8965000,703309,4.55,4201,10883,6683,0.450860468123942,4496.90397375865,28186,4.55
2006-03-21,8265314,8965000,699686,4.54,-3086,3791,6877,-0.23542355711567,4299.21338643053,25100,4.54
2006-03-22,8261201,8965000,703799,4.58,-2892,9889,12782,-0.194015108186256,3749.62981622588,22208,4.58
2006-03-23,8276421,8965000,688579,4.64,6745,81318,74573,0.746072935066752,4663.13568388796,28953,4.64
2006-03-24,8277089,8965000,687911,4.69,-8295,7219,15514,-0.714700181982674,4307.70940669629,20658,4.69
2006-03-27,8278110,8965000,686890,4.77,4604,13235,8632,0.531553969325934,5015.06651991839,25262,4.77
2006-03-28,8281715,8965000,683285,4.7,-4905,3136,8041,-0.379520859468679,4556.90507431845,20357,4.7
2006-03-29,8280501,8965000,684499,4.69,1573,10151,8578,0.272386946170063,4065.76010894544,21930,4.69
2006-03-30,8278154,8965000,686846,4.76,-4361,70679,75040,-0.345285141594043,4241.45387809416,17569,4.76
2006-03-31,8281451,8965000,683549,5,-9372,54424,63795,-0.808872929872803,3883.14076121747,8197,5
2006-04-03,8288120,8965000,676880,4.87,1322,42856,41534,0.229189376206515,4514.9701796375,9519,4.87
2006-04-04,8299490,8965000,665510,4.76,-2446,6412,8858,-0.189777074013558,4737.35555695536,7073,4.76
2006-04-05,8299792,8965000,665208,4.76,1717,10821,9104,0.267487656005714,4081.17834865031,8790,4.76
2006-04-06,8304122,8965000,660878,4.76,-1295,71540,72835,-0.0837504316932395,4927.37737342683,7495,4.76
2006-04-07,8309200,8965000,655800,4.76,1486,16138,14651,0.246543671246011,4518.11148917016,8981,4.76
2006-04-10,8312871,8965000,652129,4.78,2965,12238,9273,0.376212979592883,4469.3640195986,11946,4.78
2006-04-11,8317483,8965000,647517,4.74,-394,9359,9753,-0.0373633016080973,4038.19798566496,11552,4.74
2006-04-12,8313938,8965000,651062,4.78,-1039,11294,12334,-0.122040070226165,4318.78066226223,10513,4.78
2006-04-13,8316615,8965000,648385,4.82,-1014,74710,75724,-0.103668202544746,4393.40859860379,9499,4.82
2006-04-14,8317664,8965000,647336,4.8,4250,19312,15062,0.63421193901322,4739.72233029045,13749,4.8
2006-04-17,8277869,8965000,687131,4.78,-559,67498,68058,-0.0895398730201607,4181.94009316933,13190,4.78
2006-04-18,8281658,8965000,683342,4.72,17006,24398,7392,2.34047056597979,3910.87865771834,30196,4.72
2006-04-19,8280012,8965000,684988,4.7,8383,20004,11621,1.07652365558985,4093.52090581558,38579,4.7
2006-04-20,8258696,8965000,706304,4.73,-20273,65307,85580,-2.65292734881911,4250.10329622368,18306,4.73
2006-04-21,8259413,8965000,705587,4.74,2936,18003,15066,0.352852966142994,4069.31771395929,21242,4.74
2006-04-24,8261517,8965000,703483,4.77,15698,24009,8311,1.98817732628197,4216.57161872925,36940,4.77
2006-04-25,8270504,8965000,694496,4.74,32407,40487,8080,3.4509625396508,3975.93384498316,69347,4.74
2006-04-26,8270255,8965000,694745,4.73,8342,21433,13091,0.743031475242123,4265.97640138138,77689,4.73
2006-04-27,8247444,8965000,717556,4.79,-16721,66522,83243,-1.94282144145176,4424.52361600336,60968,4.79
2006-04-28,8262718,8965000,702282,4.86,18035,32455,14420,1.69953128700344,3926.78685441418,79003,4.86
2006-05-01,8258697,8965000,706303,4.84,4963,77835,72872,0.328246063756582,4111.92526065423,83966,4.84
2006-05-02,8272627,8965000,692373,4.79,16243,23743,7500,1.42149511126399,4067.46143794952,100209,4.79
2006-05-03,8266218,8965000,698782,4.81,-11416,18522,29938,-1.3346664237611,4150.77452401432,88793,4.81
2006-05-04,8261316,8965000,703684,4.83,-8529,65594,74122,-0.99848286318408,4517.81208978101,80264,4.83
2006-05-05,8263269,8965000,701731,4.83,-1100,10755,11854,-0.29166562631516,4324.12431762614,79164,4.83
2006-05-08,8267709,8965000,697291,4.88,3836,12575,8739,0.211203212904075,4152.90866933924,83000,4.88
2006-05-09,8271029,8965000,693971,4.78,-5578,4423,10001,-0.726938516826641,4841.91970283793,77422,4.78
2006-05-10,8267040,8965000,697960,4.88,-3656,9135,12792,-0.511675453912574,4232.50758153813,73766,4.88
2006-05-11,8267454,8965000,697546,4.99,-9062,62224,71286,-1.00562432043302,4700.39863929156,64704,4.99
2006-05-12,8268528,8965000,696472,5.01,-298,8239,8537,-0.134489940810525,4907.75151180123,64406,5.01
2006-05-15,8242403,8965000,722597,5.01,-39760,63273,103034,-3.40448878879762,4635.45507320633,24646,5.01
2006-05-16,8248178,8965000,716822,4.98,3703,10983,7280,0.310685536275765,4318.82604667386,28349,4.98
2006-05-17,8251267,8965000,713733,4.96,-3844,8664,12508,-0.334468211393081,4468.79545682286,24505,4.96
2006-05-18,8251118,8965000,713882,5,10,70224,70214,0.0104141083265622,4547.11716758149,24515,5
2006-05-19,8250779,8965000,714221,5,-1163,8631,9793,-0.106618925893611,4537.14024224266,23352,5
2006-05-22,8252573,8965000,712427,5,3386,11192,7806,0.29049302845852,4545.39683732127,26738,5
2006-05-23,8260415,8965000,704585,4.94,-4190,3296,7486,-0.368415249388396,4344.21689218543,22548,4.94
2006-05-24,8256251,8965000,708749,4.9,-4330,7919,12249,-0.367189069493259,4303.32251953567,18218,4.9
2006-05-25,8254533,8965000,710467,5.01,-3360,68013,71373,-0.285507131316756,4411.20161220183,14858,5.01
2006-05-26,8257108,8965000,707892,4.99,641,8375,7734,0.0401014766652079,4400.54395221736,15499,4.99
2006-05-30,8252824,8965000,712176,5.02,3278,10870,7592,0.26627363281109,3863.27056391343,18777,5.02
2006-05-31,8263809,8965000,701191,5.05,9299,51876,42577,0.76153419977146,4234.17675250202,28076,5.05
2006-06-01,8251840,8965000,713160,5.02,-19273,82153,101426,-1.61469049857451,3925.22994493761,8803,5.02
2006-06-02,8267812,8965000,697188,4.97,-1736,30570,32307,-0.144525744453119,4351.26965379072,7067,4.97
2006-06-05,8269836,8965000,695164,5.01,295,9971,9675,0.0281077464980556,4488.40997856861,7362,5.01
2006-06-06,8283438,8965000,681562,4.99,3944,13187,9243,0.331584850662878,4369.72628179132,11306,4.99
2006-06-07,8282263,8965000,682737,4.99,3850,11103,7252,0.314424374117648,3827.29421134027,15156,4.99
2006-06-08,8283625,8965000,681375,5.02,-5539,68470,74010,-0.460097699414864,4937.66270328671,9617,5.02
2006-06-09,8284817,8965000,680183,5,1342,7223,5882,0.108874657548518,4641.86686240073,10959,5
2006-06-12,8286082,8965000,678918,5.01,5904,12242,6338,0.485165029466947,4296.14991637492,16863,5.01
2006-06-13,8290795,8965000,674205,5,1388,7846,6458,0.105036326603264,3685.80368656186,18251,5
2006-06-14,8285541,8965000,679459,5,5071,16586,11515,0.447164565653624,3976.82030557796,23322,5
2006-06-15,8243708,8965000,721292,5.02,10783,130052,119269,0.925206609075866,3973.64134552392,34105,5.02
2006-06-16,8245869,8965000,719131,4.94,7896,17376,9481,0.642109078082782,4527.68252785196,42001,4.94
2006-06-19,8251247,8965000,713753,4.95,7389,15156,7767,0.585420344097169,4322.37313087842,49390,4.95
2006-06-20,8256054,8965000,708946,4.92,10866,22164,11298,0.911484883932224,4111.80411133605,60256,4.92
2006-06-21,8254032,8965000,710968,4.91,3608,14615,11007,0.372628186962463,4023.25506009393,63864,4.91
2006-06-22,8246204,8965000,718796,4.98,-14377,64312,78689,-1.34041126358414,4017.35271862865,49487,4.98
2006-06-23,8249925,8965000,715075,4.98,2642,8336,5695,0.289935843499098,4088.02656653919,52129,4.98
2006-06-26,8253508,8965000,711492,5.03,6245,12360,6115,0.712867779693104,4792.95772089487,58374,5.03
2006-06-27,8257279,8965000,707721,5.02,-2374,4461,6835,-0.177307143241468,4617.19609092613,56000,5.02
2006-06-28,8252987,8965000,712013,5.06,-2514,8902,11416,-0.148880910570408,4373.7904503952,53486,5.06
2006-06-29,8246457,8965000,718543,5.08,-3810,68287,72096,-0.318279567707346,4537.34181769843,49676,5.08
2006-06-30,8330646,8965000,634354,5.05,-3893,54290,58183,-0.343371304287814,4180.4885591109,45783,5.05
2006-07-03,8306228,8965000,658772,5.25,-25426,23313,48739,-2.48398937786894,4207.31607695792,20357,5.25
2006-07-05,8315425,8965000,649575,5.25,-2524,6159,8683,-0.093145697849334,4486.53447153655,17833,5.25
2006-07-06,8316226,8965000,648774,5.24,-541,71796,72337,0.100374198976,5011.06498201413,17292,5.24
2006-07-07,8317832,8965000,647168,5.22,-1194,6611,7805,0.0258549985957285,4342.12128860084,16098,5.22
2006-07-10,8315241,8965000,649759,5.24,3646,9948,6302,0.500432388675928,4060.86771515645,19744,5.24
2006-07-11,8320174,8965000,644826,5.25,-3483,3475,6958,-0.238978766631818,3800.13865442528,16261,5.25
2006-07-12,8315704,8965000,649296,5.27,-2422,8435,10857,-0.298405349002418,4374.62763331449,13839,5.27
2006-07-13,8322687,8965000,642313,5.26,2052,64055,62002,0.328601218430461,4522.64027492229,15891,5.26
2006-07-14,8323084,8965000,641916,5.26,-696,10641,11337,-0.0646094845490552,4034.54760981613,15195,5.26
2006-07-17,8311633,8965000,653367,5.28,-603,36691,37294,-0.0495005463027542,4308.43825302844,14592,5.28
2006-07-18,8318972,8965000,646028,5.22,-2190,4550,6740,-0.267061261547985,4445.45438318918,12402,5.22
2006-07-19,8316966,8965000,648034,5.23,16,10064,10048,0.0523004501197081,4510.87645471282,12418,5.23
2006-07-20,8324802,8965000,640198,5.24,309,65929,65620,0.0778334764201612,4378.71426905205,12727,5.24
2006-07-21,8325985,8965000,639015,5.23,-425,6256,6681,-0.0390623349061926,4489.86152816136,12302,5.23
2006-07-24,8324801,8965000,640199,5.24,4205,9940,5735,0.585886919298387,4269.68274164319,16507,5.24
2006-07-25,8329415,8965000,635585,5.24,-3567,3721,7288,-0.491390940310704,3883.1880948724,12940,5.24
2006-07-26,8326902,8965000,638098,5.24,-2704,8898,11603,-0.34980409013604,4287.48653309005,10236,5.24
2006-07-27,8334873,8965000,630127,5.27,3059,74558,71499,0.491706994439743,4157.39195289547,13295,5.27
2006-07-28,8332047,8965000,632953,5.26,-713,8546,9259,-0.128906511024819,3877.92038636895,12582,5.26
2006-07-31,8352614,8965000,612386,5.31,25118,66264,41146,3.29126186258531,4132.24427088788,37700,5.31
2006-08-01,8348782,8965000,616218,5.27,-23567,13691,37258,-2.84605159491357,4252.60872055715,14133,5.27
2006-08-02,8350823,8965000,614177,5.25,4544,11273,6729,0.522274670230734,4021.73457592695,18677,5.25
2006-08-03,8359705,8965000,605295,5.27,-13250,80395,93645,-1.51428374072761,5043.77248237549,5427,5.27
2006-08-04,8359492,8965000,605508,5.25,1108,8699,7591,0.138626499469773,4367.09717134486,6535,5.25
2006-08-07,8360231,8965000,604769,5.24,3153,10125,6972,0.372009484810181,4286.78604884492,9688,5.24
2006-08-08,8366644,8965000,598356,5.26,-3418,3619,7037,-0.370001032057652,4512.49287059191,6270,5.26
2006-08-09,8360341,8965000,604659,5.25,-2931,8574,11505,-0.299978256309912,4169.59201412869,3339,5.25
2006-08-10,8370109,8965000,594891,5.24,5119,78130,73011,0.643776187707392,4349.22995364496,8458,5.24
2006-08-11,8371503,8965000,593497,5.24,-2252,6658,8910,-0.186427159453739,5085.59239506374,6206,5.24
2006-08-14,8368346,8965000,596654,5.26,4128,12416,8288,0.595612799278524,4129.70695105443,10334,5.26
2006-08-15,8399163,8965000,565837,5.24,-6468,58836,65304,-0.650121766581868,4577.83949838959,3866,5.24
2006-08-16,8394370,8965000,570630,5.17,4187,15473,11286,0.685354026599058,4270.32001477306,8053,5.17
2006-08-17,8409664,8965000,555336,5.2,7382,79596,72214,1.06153504704179,4597.06927826918,15435,5.2
2006-08-18,8411025,8965000,553975,5.25,2003,7915,5912,0.358542478526345,4169.35353245217,17438,5.25
2006-08-21,8411575,8965000,553425,5.24,5332,11533,6201,0.771458299961598,4419.27601375093,22770,5.24
2006-08-22,8414124,8965000,550876,5.24,-2964,3525,6489,-0.256783749763277,4121.95793388654,19806,5.24
2006-08-23,8413511,8965000,551489,5.25,-3270,7898,11168,-0.292994453547116,4203.92284403168,16536,5.25
2006-08-24,8415497,8965000,549503,5.25,-3676,77905,81581,-0.341012687798579,4201.27971169179,12860,5.25
2006-08-25,8416236,8965000,548764,5.25,-2121,6989,9109,-0.147306801259989,4751.39171758846,10739,5.25
2006-08-28,8412475,8965000,552525,5.25,4011,11312,7301,0.612547064372055,4615.49578714044,14750,5.25
2006-08-29,8416504,8965000,548496,5.23,-2209,5648,7857,-0.299520846988388,3920.04220691159,12541,5.23
2006-08-30,8411577,8965000,553423,5.25,1109,7766,6658,0.180725777627451,3352.71093189633,13650,5.25
2006-08-31,8423321,8965000,541679,5.31,2790,124860,122070,0.417720750392805,4026.76001498152,16440,5.31
2006-09-01,8431580,8965000,533420,5.25,-11948,44763,56711,-1.66826761211541,4291.30189027666,4492,5.25
2006-09-05,8436829,8965000,528171,5.26,4218,12307,8088,0.642268641707792,4502.99650594354,8710,5.26
2006-09-06,8442244,8965000,522756,5.21,-2320,7120,9439,-0.296786506301539,4624.06135957806,6390,5.21
2006-09-07,8441441,8965000,523559,5.23,1297,84781,83484,0.207832221417263,4438.16821528239,7687,5.23
2006-09-08,8440841,8965000,524159,5.23,-1573,8305,9878,-0.190482489392546,4782.0726415652,6114,5.23
2006-09-11,8442989,8965000,522011,5.24,3748,11823,8076,0.554257385645489,4286.68554909564,9862,5.24
2006-09-12,8446600,8965000,518400,5.21,-551,7291,7842,-0.0598308035654052,4299.22200787722,9311,5.21
2006-09-13,8442100,8965000,522900,5.26,-1090,10096,11185,-0.14085192658803,4509.74513657096,8221,5.26
2006-09-14,8439372,8965000,525628,5.26,-1435,82436,83871,-0.184894910960905,4752.92484277956,6786,5.26
2006-09-15,8395748,8965000,569252,5.25,34474,94590,60117,3.79922932998726,3842.92453448904,41260,5.25
2006-09-18,8399096,8965000,565904,5.23,15181,21602,6421,1.534686822456,4255.22091269925,56441,5.23
2006-09-19,8405786,8965000,559214,5.21,13909,20562,6654,1.33891042955365,4057.10235902267,70350,5.21
2006-09-20,8403140,8965000,561860,5.23,5445,17176,11731,0.413401045553027,4499.57585540809,75795,5.23
2006-09-21,8392632,8965000,572368,5.24,-12282,68851,81134,-1.41786396299165,4366.65464956543,63513,5.24
2006-09-22,8392754,8965000,572246,5.27,1901,10539,8638,0.0623064804329483,3960.93845742295,65414,5.27
2006-09-25,8394530,8965000,570470,5.3,6235,14152,7917,0.494446638008701,4212.12591829676,71649,5.3
2006-09-26,8399529,8965000,565471,5.25,-517,6222,6738,-0.153211737586492,4470.55803874391,71132,5.25
2006-09-27,8400241,8965000,564759,5.3,-1454,10619,12073,-0.359526892126907,4162.79246934761,69678,5.3
2006-09-28,8386065,8965000,578935,5.28,-17028,62531,79558,-2.12679168269296,3587.57689403794,52650,5.28
2006-09-29,8420278,8965000,544722,5.34,-519,13426,13945,-0.208390783911632,4404.490152917,52131,5.34
2006-10-02,8461948,8965000,503052,5.33,651,64756,64106,-0.0624146191403309,4162.8559046092,52782,5.33
2006-10-03,8461327,8965000,503673,5.25,-26038,4454,30492,-2.8905293110542,4326.33709545293,26744,5.25
2006-10-04,8459602,8965000,505398,5.23,791,10749,9958,0.0283954035646113,4266.50287139096,27535,5.23
2006-10-05,8458163,8965000,506837,5.23,-6937,58970,65906,-0.801348170001571,4612.50038792101,20598,5.23
2006-10-06,8460228,8965000,504772,5.22,-1863,7775,9638,-0.231178745047946,4748.57811993349,18735,5.22
2006-10-10,8460038,8965000,504962,5.28,1912,11454,9543,0.169237453414876,4342.91967624152,20647,5.28
2006-10-11,8458860,8965000,506140,5.25,-8716,6095,14811,-0.946208300091667,4259.7585790262,11931,5.25
2006-10-12,8459282,8965000,505718,5.25,-206,61879,62085,-0.0437779783518019,4361.81118444278,11725,5.25
2006-10-13,8459959,8965000,505041,5.21,-1313,8837,10149,-0.149559432556485,4823.13777699466,10412,5.21
2006-10-16,8450656,8965000,514344,5.28,2082,36024,33941,0.236793750762012,4118.48212243991,12494,5.28
2006-10-17,8457868,8965000,507132,5.21,-300,6141,6441,-0.0185670206000526,4140.26677184738,12194,5.21
2006-10-18,8454008,8965000,510992,5.23,2732,14972,12240,0.322976862964152,4547.24355115185,14926,5.23
2006-10-19,8461282,8965000,503718,5.22,9069,69658,60589,0.977479336219098,4665.65806481548,23995,5.22
2006-10-20,8462643,8965000,502357,5.25,-1198,8991,10189,-0.147920759860586,3655.78609703872,22797,5.25
2006-10-24,8468357,8965000,496643,5.24,-969,5876,6845,-0.130575167939349,4049.77812756942,21828,5.24
2006-10-25,8464347,8965000,500653,5.26,-1738,9892,11631,-0.215831574169533,4592.89977384002,20090,5.26
2006-10-26,8479008,8965000,485992,5.23,8544,69469,60925,0.889848493870547,4529.44403286158,28634,5.23
2006-10-27,8479353,8965000,485647,5.23,728,8094,7366,0.0334125814757221,4449.89821062467,29362,5.23
2006-10-30,8476194,8965000,488806,5.27,3474,10382,6908,0.324960720803181,4297.72264490622,32836,5.27
2006-10-31,8498016,8965000,466984,5.31,20241,59872,39631,1.98702425825559,3776.75121243575,53077,5.31
2006-11-01,8484722,8965000,480278,5.23,-17377,18655,36033,-1.82573147428043,4235.70557333347,35700,5.23
2006-11-02,8505343,8965000,459657,5.22,13011,76390,63379,1.1870001045244,4017.761462635,48711,5.22
2006-11-03,8497315,8965000,467685,5.25,-20851,9272,30123,-2.002010434398,4930.20343466097,27860,5.25
2006-11-06,8500557,8965000,464443,5.24,1969,10746,8777,0.132472110090338,4385.48233071527,29829,5.24
2006-11-07,8504918,8965000,460082,5.22,-5224,3661,8885,-0.530482524966571,4626.10727054307,24605,5.22
2006-11-08,8500868,8965000,464132,5.22,-2714,9700,12414,-0.281303932616183,4595.79138140849,21891,5.22
2006-11-09,8515344,8965000,449656,5.23,9623,74017,64395,0.838341573013311,4371.87954885339,31514,5.23
2006-11-09,8515344,8965000,449656,5.23,9623,74017,64395,0.838341573013311,4371.87954885339,31514,5.23
2006-11-13,8515514,8965000,449486,5.27,4313,9965,5652,0.334545727733974,4313.3303702058,35827,5.27
2006-11-14,8519788,8965000,445212,5.25,-2679,5943,8622,-0.308017602217056,4175.58578525217,33148,5.25
2006-11-15,8507356,8965000,457644,5.29,-32992,71951,104943,-2.99054483023823,4326.90254841637,156,5.29
2006-11-16,8518358,8965000,446642,5.25,10387,83772,73385,1.09562358745917,4133.13220123155,10543,5.25
2006-11-17,8520558,8965000,444442,5.2,-2995,6477,9472,-0.139110495799726,4513.85192772169,7548,5.2
2006-11-20,8521207,8965000,443793,5.25,1522,10838,9316,0.312970134280795,4330.53823655374,9070,5.25
2006-11-21,8525849,8965000,439151,5.29,-3909,4371,8280,-0.243690851722705,4012.63873626542,5161,5.29
2006-11-22,8522422,8965000,442578,5.26,-3930,10323,14253,-0.231458146765488,3993.82461989062,1231,5.26
2006-11-24,8534951,8965000,430049,5.24,11728,84142,72414,1.29451174129703,4486.80113928532,12959,5.24
2006-11-27,8538830,8965000,426170,5.32,2189,7557,5368,0.351525023726461,3942.23568187248,15148,5.32
2006-11-28,8540798,8965000,424202,5.24,-5735,3433,9168,-0.413263787522574,4153.53958394486,9413,5.24
2006-11-29,8536856,8965000,428144,5.26,2859,10721,7862,0.389295951287394,3357.16507956171,12272,5.26
2006-11-30,8545715,8965000,419285,5.31,3549,124859,121310,0.447331350453049,4011.87222997973,15821,5.31
2006-12-01,8548150,8965000,416850,5.27,-15347,45975,61323,-1.37415574183924,3943.93269968981,474,5.27
2006-12-04,8553003,8965000,411997,5.22,2072,12737,10666,0.284580639352424,4080.5516783886,2546,5.22
2006-12-05,8568469,8965000,396531,5.21,5619,14809,9190,0.645445928773698,4185.77497176875,8165,5.21
2006-12-06,8567069,8965000,397931,5.22,2757,10755,7998,0.318680657284972,4053.48822258495,10922,5.22
2006-12-07,8566426,8965000,398574,5.25,-5085,73151,78237,-0.504596095670193,4593.61519100325,5837,5.25
2006-12-08,8568019,8965000,396981,5.25,319,6855,6536,0.0722299465410322,4709.12048093572,6156,5.25
2006-12-11,8568413,8965000,396587,5.25,4436,11185,6749,0.477388978522781,4160.54422912913,10592,5.25
2006-12-12,8573637,8965000,391363,5.23,-3260,5146,8406,-0.335974970226226,4351.34490065364,7332,5.23
2006-12-13,8570228,8965000,394772,5.23,-1113,11133,12246,-0.107531617811174,4378.81961263535,6219,5.23
2006-12-14,8561387,8965000,403613,5.29,-6125,74940,81065,-0.617549858988561,3906.15107316002,94,5.29
2006-12-15,8524629,8965000,440371,5.27,40150,95172,55022,3.46533374499067,4093.3527213749,40244,5.27
2006-12-18,8527461,8965000,437539,5.21,13837,22253,8416,1.11147408205427,4180.63658430149,54081,5.21
2006-12-19,8535421,8965000,429579,5.21,-2045,5299,7344,-0.238732409206895,4347.77882965398,52036,5.21
2006-12-20,8532420,8965000,432580,5.26,2606,13992,11386,0.157351086849323,4112.48577234959,54642,5.26
2006-12-21,8522697,8965000,442303,5.25,-15479,67618,83097,-1.35027111571245,4397.91417515889,39163,5.25
2006-12-22,8524478,8965000,440522,5.24,3019,10436,7417,0.209288800740407,4698.37503216348,42182,5.24
2006-12-26,8528803,8965000,436197,5.29,7278,15311,8033,0.574322439059233,4526.98419182306,49460,5.29
2006-12-27,8528276,8965000,436724,5.17,-7143,6559,13702,-0.631294687727204,3706.59311249391,42317,5.17
2006-12-28,8505868,8965000,459132,5.25,-14476,68588,83064,-1.1915743183517,4065.42340665727,27841,5.25
2006-12-29,8592513,8965000,372487,5.17,-2256,15803,18060,-0.135408526465063,3843.82998597897,25585,5.17
2007-01-02,8590754,8965000,374246,5.3,9305,75764,66459,0.820494151215949,4348.01626460868,34890,5.3
2007-01-03,8589878,8965000,375122,5.28,-19424,8422,27846,-1.60739239308322,4035.32809340561,15466,5.28
2007-01-04,8582558,8965000,382442,5.24,-6933,67652,74585,-0.578391939801955,3813.133524881,8533,5.24
2007-01-05,8585248,8965000,379752,5.21,433,8699,8267,0.0856483068959588,4803.55380438143,8966,5.21
2007-01-08,8585305,8965000,379695,5.23,4883,11980,7097,0.462032599790444,4358.02138690601,13849,5.23
2007-01-09,8590330,8965000,374670,5.25,982,8528,7546,0.103947556850239,4042.71412798814,14831,5.25
2007-01-10,8586128,8965000,378872,5.26,-2993,9396,12389,-0.226577314131295,4417.58275521878,11838,5.26
2007-01-11,8586394,8965000,378606,5.27,-3663,60175,63839,-0.269624581375101,4503.18162119762,8175,5.27
2007-01-12,8586444,8965000,378556,5.22,-516,11947,12462,0.0110035250445717,4224.8327329527,7659,5.22
2007-01-16,8581141,8965000,383859,5.28,8156,44159,36003,0.794834953050504,4119.73247503682,15815,5.28
2007-01-17,8584827,8965000,380173,5.25,8491,21482,12990,0.837861275556487,4248.42106347049,24306,5.25
2007-01-18,8584821,8965000,380179,5.23,853,66359,65506,0.0425111971450165,4525.95314314767,25159,5.23
2007-01-19,8586448,8965000,378552,5.25,4553,11319,6766,0.414936259713299,4879.72437380286,29712,5.25
2007-01-22,8588430,8965000,376570,5.24,13262,19604,6342,1.24335001221028,4922.98897270721,42974,5.24
2007-01-23,8593540,8965000,371460,5.26,11172,17727,6555,0.984638623443066,4130.70974290844,54146,5.26
2007-01-24,8591846,8965000,373154,5.27,2029,13217,11188,0.0962007352416288,4500.60721502868,56175,5.27
2007-01-25,8594777,8965000,370223,5.31,-3271,62148,65418,-0.426494558676713,4783.33377833082,52904,5.31
2007-01-26,8594653,8965000,370347,5.26,-6940,9018,15958,-0.792882132182973,4237.92300206464,45964,5.26
2007-01-29,8599854,8965000,365146,5.26,11470,19132,7662,1.0298367658189,4569.20876160664,57434,5.26
2007-01-30,8600801,8965000,364199,5.23,-3107,4282,7389,-0.404724512663324,4602.54243085034,54327,5.23
2007-01-31,8619499,8965000,345501,5.33,24417,62539,38121,2.16745563692191,3638.51249335298,78744,5.33
2007-02-01,8606112,8965000,358888,5.29,-17599,77240,94839,-1.76292650783237,4250.65582502949,61145,5.29
2007-02-02,8604695,8965000,360305,5.24,-28633,9526,38159,-2.48049496874451,4260.69223938202,32512,5.24
2007-02-05,8607663,8965000,357337,5.25,3303,11478,8174,0.227339373275385,3900.20960324011,35815,5.25
2007-02-06,8611425,8965000,353575,5.24,-3689,4901,8590,-0.369067202854021,4274.21352080457,32126,5.24
2007-02-07,8611374,8965000,353626,5.23,3324,11070,7746,0.219936797156953,3634.28195392638,35450,5.23
2007-02-08,8624463,8965000,340537,5.25,7662,73829,66166,0.579412557611937,4682.12460821211,43112,5.25
2007-02-09,8624456,8965000,340544,5.25,-22157,7181,29338,-1.82119808221678,4547.99750064498,20955,5.25
2007-02-12,8625262,8965000,339738,5.28,3153,12335,9182,0.218936583343569,4195.58502523406,24108,5.28
2007-02-13,8629904,8965000,335096,5.26,-4154,3555,7709,-0.376993762116477,4532.5745471417,19954,5.26
2007-02-14,8624787,8965000,340213,5.27,-1677,10528,12206,-0.107119663597443,4246.64642142143,18277,5.27
2007-02-15,8649163,8965000,315837,5.29,-8678,126271,134949,-0.731718637068506,4541.15717649007,9599,5.29
2007-02-16,8656653,8965000,308347,5.24,-8693,22804,31497,-0.712370870942966,4433.47012391902,906,5.24
2007-02-20,8663295,8965000,301705,5.27,7804,14953,7149,0.853378813857375,4237.89897658194,8710,5.27
2007-02-21,8663765,8965000,301235,5.23,-6224,6865,13089,-0.516961591028534,4501.88705371919,2486,5.23
2007-02-22,8678988,8965000,286012,5.26,14792,91321,76529,1.46157535391308,4387.91089343553,17278,5.26
2007-02-23,8680010,8965000,284990,5.24,-15483,9440,24923,-1.33291060629574,4089.55051319824,1795,5.24
2007-02-26,8683983,8965000,281017,5.3,5460,13934,8474,0.590669967043303,4153.56716789966,7255,5.3
2007-02-27,8685187,8965000,279813,5.27,-3261,5344,8605,-0.253612063793012,4211.86163303984,3994,5.27
2007-02-28,8690921,8965000,274079,5.41,2435,52011,49577,0.277127347514491,4012.4015144913,6429,5.41
2007-03-01,8700541,8965000,264459,5.31,4708,103552,98844,0.508336213092328,4228.52465847151,11137,5.31
2007-03-02,8720782,8965000,244218,5.23,-10255,32885,43140,-0.979162939580873,4879.30503833721,882,5.23
2007-03-05,8724536,8965000,240464,5.27,5014,13696,8681,0.504047000626931,4022.89184887908,5896,5.27
2007-03-06,8731681,8965000,233319,5.22,-1429,7500,8929,-0.130604881273677,3904.2063026905,4467,5.22
2007-03-07,8731314,8965000,233686,5.24,3322,12004,8682,0.34516219473491,4109.45522284541,7789,5.24
2007-03-08,8744967,8965000,220033,5.24,8346,86872,78526,0.818923106923784,4551.65719785941,16135,5.24
2007-03-09,8744425,8965000,220575,5.24,-11669,8072,19741,-1.11400412590437,4114.73382888124,4466,5.24
2007-03-12,8745413,8965000,219587,5.25,5914,15345,9432,0.566748642377158,3926.62887604096,10380,5.25
2007-03-13,8750821,8965000,214179,5.25,-4198,4461,8659,-0.401676009939551,4059.77154050707,6182,5.25
2007-03-14,8745728,8965000,219272,5.27,1908,14858,12950,0.204402008458402,4311.23935519449,8090,5.27
2007-03-15,8737824,8965000,227176,5.29,19330,130506,111176,1.80765627019298,4418.91314655826,27420,5.29
2007-03-16,8739672,8965000,225328,5.25,2596,19881,17286,0.23219848098283,4263.45814581439,30016,5.25
2007-03-19,8746798,8965000,218202,5.26,4107,11349,7242,0.37518665295532,4111.34311995484,34123,5.26
2007-03-20,8750482,8965000,214518,5.26,-3058,4501,7559,-0.264228720751939,4136.12469292172,31065,5.26
2007-03-21,8746491,8965000,218509,5.26,-1734,11569,13303,-0.108316646001222,4422.66627286201,29331,5.26
2007-03-22,8744449,8965000,220551,5.27,-2911,83132,86043,-0.210846170728636,4684.58850448459,26420,5.27
2007-03-23,8749856,8965000,215144,5.24,-8559,7885,16444,-0.742644966323811,4287.35673220766,17861,5.24
2007-03-26,8754421,8965000,210579,5.28,3215,11951,8737,0.371919248926028,4736.19413706493,21076,5.28
2007-03-27,8758756,8965000,206244,5.25,-5613,4695,10308,-0.44935255370212,4099.58767109765,15463,5.25
2007-03-28,8753570,8965000,211430,5.27,-5632,8905,14537,-0.444092176532521,4852.64123826413,9831,5.27
2007-03-29,8748689,8965000,216311,5.29,-5016,80878,85893,-0.340211005419576,4220.97510841666,4815,5.29
2007-03-30,8760735,8965000,204265,5.3,-3927,26721,30648,-0.270074839634109,4219.18019532645,888,5.3
2007-04-02,8761722,8965000,203278,5.25,7758,63499,55741,1.05415919730954,4611.33790617437,8646,5.25
2007-04-03,8780295,8965000,184705,5.2,-7638,22279,29917,-0.848521871208141,4831.76769412603,1008,5.2
2007-04-04,8781424,8965000,183576,5.21,2447,11897,9450,0.396491918060942,3943.62795341049,3455,5.21
2007-04-05,8796035,8965000,168965,5.3,4585,87500,82915,0.65892448772945,4379.7471510514,8040,5.3
2007-04-06,8792685,8965000,172315,5.3,-6649,8941,15590,-0.706475604881703,4471.24455526824,1391,5.3
2007-04-09,8794697,8965000,170303,5.28,2611,11640,9029,0.422955714881358,4141.83810692406,4002,5.28
2007-04-10,8798617,8965000,166383,5.26,-1166,8245,9411,-0.0886678759040393,4260.74892477837,2836,5.26
2007-04-11,8797982,8965000,167018,5.24,2031,15585,13554,0.337323710514936,4255.52554296475,4867,5.24
2007-04-12,8794903,8965000,170097,5.27,-6143,75382,81526,-0.785889496577771,4309.88007788086,-1276,5.27
2007-04-13,8804354,8965000,160646,5.25,8049,22279,14230,1.12889793024938,4498.27182574086,6773,5.25
2007-04-16,8781143,8965000,183857,5.29,-2403,42429,44832,-0.352292086770111,4376.16554587696,4370,5.29
2007-04-17,8760733,8965000,204267,5.2,19485,58054,38570,2.50933901819838,3955.72409230528,23855,5.2
2007-04-18,8754390,8965000,210610,5.19,-4966,17217,22182,-0.708432457482776,4622.02387565695,18889,5.19
2007-04-19,8733542,8965000,231458,5.23,-12778,68280,81058,-1.66640596111084,4565.60716967391,6111,5.23
2007-04-20,8736437,8965000,228563,5.25,3886,19931,16044,0.517805701079306,4472.90002762669,9997,5.25
2007-04-23,8739509,8965000,225491,5.23,18607,26392,7785,2.36503062847002,4334.89138839791,28604,5.23
2007-04-24,8747695,8965000,217305,5.2,43609,51796,8187,4.10508747907385,4397.06440482269,72213,5.2
2007-04-25,8747643,8965000,217357,5.19,15637,29105,13468,1.30249538218526,4290.75438912294,87850,5.19
2007-04-26,8730404,8965000,234596,5.24,-11082,70112,81195,-1.19623586714939,4577.98901464977,76768,5.24
2007-04-27,8728257,8965000,236743,5.24,6917,22580,15663,0.462106962405245,4337.36730550424,83685,5.24
2007-04-30,8753070,8965000,211930,5.29,34955,77797,42842,2.74614222572986,4204.04165654909,118640,5.29
2007-05-01,8737664,8965000,227336,5.26,-6988,33161,40149,-0.820206300666908,3827.82204507082,111652,5.26
2007-05-02,8748514,8965000,216486,5.21,6880,15646,8766,0.348272247275633,3624.18717805625,118532,5.21
2007-05-03,8726282,8965000,238718,5.24,-39897,59053,98950,-3.0585219365856,4261.33697655768,78635,5.24
2007-05-04,8728157,8965000,236843,5.24,-433,11812,12245,-0.170012680137485,4613.43433510066,78202,5.24
2007-05-07,8732596,8965000,232404,5.24,1687,12563,10876,-0.00379300268802812,4620.4095684429,79889,5.24
2007-05-08,8740750,8965000,224250,5.21,-5198,4018,9216,-0.516279800769667,4361.20670719208,74691,5.21
2007-05-09,8735317,8965000,229683,5.21,-3978,9764,13742,-0.413214353976568,4429.23296406951,70713,5.21
2007-05-10,8729237,8965000,235763,5.25,-13361,56092,69453,-1.06076520913148,4631.0961638225,57352,5.25
2007-05-11,8730917,8965000,234083,5.27,-1679,7191,8870,-0.17442861966305,4650.56326772821,55673,5.27
2007-05-14,8732448,8965000,232552,5.26,4420,12631,8210,0.283404471692509,4164.0839487863,60093,5.26
2007-05-15,8716135,8965000,248865,5.29,-41810,57402,99212,-2.78504348591476,4141.36111587283,18283,5.29
2007-05-16,8713797,8965000,251203,5.25,3174,16881,13707,0.226142664971202,4209.48706712041,21457,5.25
2007-05-17,8716829,8965000,248171,5.25,-5006,63811,68817,-0.318833405285877,4502.67351234021,16451,5.25
2007-05-18,8717062,8965000,247938,5.24,-1472,9225,10697,-0.0942088953234039,4640.80149712464,14979,5.24
2007-05-21,8719737,8965000,245263,5.24,3629,11630,8002,0.248322061214593,4361.51530752533,18608,5.24
2007-05-22,8724449,8965000,240551,5.23,-4254,3922,8176,-0.284576805911012,4143.10065957814,14354,5.23
2007-05-23,8722186,8965000,242814,5.25,-4654,8778,13432,-0.313339933087338,3997.68048819741,9700,5.25
2007-05-24,8728701,8965000,236299,5.24,-982,69724,70705,-0.0728400014881792,4360.02282104119,8718,5.24
2007-05-25,8728872,8965000,236128,5.29,-44,7059,7103,-0.0161175329229757,4878.65373701745,8674,5.29
2007-05-29,8731502,8965000,233498,5.29,6385,13953,7568,0.420857538332974,3860.55758741069,15059,5.29
2007-05-30,8732509,8965000,232491,5.25,-3208,7159,10368,-0.235916070180695,3834.9567613092,11851,5.25
2007-05-31,8740892,8965000,224108,5.28,9200,115505,106306,0.591452994644651,4682.05709869036,21051,5.28
2007-06-01,8740281,8965000,224719,5.23,-18212,46235,64447,-1.19877886813732,3694.4003215291,2839,5.23
2007-06-04,8744006,8965000,220994,5.24,2580,12797,10217,0.164716308196006,3954.0921614738,5419,5.24
2007-06-05,8763291,8965000,201709,5.19,6379,15920,9540,0.410091154608187,4426.60276372048,11798,5.19
2007-06-06,8761734,8965000,203266,5.25,4706,11690,6983,0.289125974210976,4157.52871306982,16504,5.25
2007-06-07,8754495,8965000,210505,5.25,-8882,64706,73589,-0.590350755500921,4959.6960034689,7622,5.25
2007-06-08,8757254,8965000,207746,5.26,675,7325,6649,0.0287980590555069,4082.83957782497,8297,5.26
2007-06-11,8759453,8965000,205547,5.27,4995,11737,6742,0.320089187075338,4275.18504194346,13292,5.27
2007-06-12,8763456,8965000,201544,5.26,73,6566,6493,-0.0100645092232934,4452.78587881112,13365,5.26
2007-06-13,8759732,8965000,205268,5.26,-861,11865,12726,-0.0390976554655653,4253.53829480784,12504,5.26
2007-06-14,8747331,8965000,217669,5.28,-9034,70228,79262,-0.583938018217899,4579.97594807229,3470,5.28
2007-06-15,8716285,8965000,248715,5.26,21528,77529,56001,1.39759458212343,4138.70091726132,24998,5.26
2007-06-18,8720835,8965000,244165,5.23,15093,22879,7786,0.941349454245867,4133.53228476643,40091,5.23
2007-06-19,8729787,8965000,235213,5.21,14456,22063,7607,0.913000484547995,3666.34378697439,54547,5.21
2007-06-20,8726596,8965000,238404,5.27,5454,17464,12010,0.428032275935967,4206.50317696038,60001,5.27
2007-06-21,8712852,8965000,252148,5.26,-16544,64583,81127,-1.14840139381138,4679.26835644071,43457,5.26
2007-06-22,8715524,8965000,249476,5.24,4675,11374,6700,0.403188607554862,4277.03369912981,48132,5.24
2007-06-25,8719567,8965000,245433,5.29,7012,13389,6377,0.57773614839202,4269.58184265287,55144,5.29
2007-06-26,8723786,8965000,241214,5.25,-1318,5593,6911,0.0250779974757007,4473.02008013619,53826,5.25
2007-06-27,8718816,8965000,246184,5.26,-2705,10924,13629,-0.0990918051438322,4872.85029745718,51121,5.26
2007-06-28,8705712,8965000,259288,5.26,-12412,64983,77395,-0.863143574396825,4366.38082770384,38709,5.26
2007-06-29,8779168,8965000,185832,5.31,-18580,11588,30168,-1.59230019709139,4014.59619300088,20129,5.31
2007-07-02,8781003,8965000,183997,5.31,8047,62895,54848,0.856609124838704,4129.01624357213,28176,5.31
2007-07-03,8782317,8965000,182683,5.24,-25014,5606,30621,-2.01320369145248,3881.05945034895,3162,5.24
2007-07-05,8784028,8965000,180972,5.25,2156,71602,69445,0.338961418824021,3979.57315729787,5318,5.25
2007-07-06,8787264,8965000,177736,5.22,-954,7283,8236,0.0614300489670339,4121.68905737857,4364,5.22
2007-07-09,8786047,8965000,178953,5.22,3963,11235,7272,0.457341648507088,4231.92529714726,8327,5.22
2007-07-10,8789886,8965000,175114,5.24,-3830,3437,7267,-0.224673313429715,4362.77899085157,4497,5.24
2007-07-11,8784995,8965000,180005,5.24,-2156,10039,12194,-0.0629408502853955,4534.85252442171,2341,5.24
2007-07-12,8789334,8965000,175666,5.26,-994,61245,62239,-0.0618194009475812,4488.83162654032,1347,5.26
2007-07-13,8789172,8965000,175828,5.25,-1773,10406,12179,-0.133053101444074,4111.0298288833,-426,5.25
2007-07-16,8798334,8965000,166666,5.32,18610,33910,15300,1.92076762669712,3882.668377567,18184,5.32
2007-07-17,8805842,8965000,159158,5.28,-2872,4433,7304,-0.297725330222182,4384.09644778626,15312,5.28
2007-07-18,8800541,8965000,164459,5.26,-1695,9740,11436,-0.162549849658913,4487.49765769051,13617,5.26
2007-07-19,8809123,8965000,155877,5.25,2019,62239,60220,0.206070085213415,4147.80778692813,15636,5.25
2007-07-20,8809940,8965000,155060,5.25,-458,6447,6905,-0.061892729197261,4606.36374787942,15178,5.25
2007-07-23,8810966,8965000,154034,5.26,4908,11086,6178,0.479642694206879,4167.44356976107,20086,5.26
2007-07-24,8815188,8965000,149812,5.25,-3262,3616,6879,-0.358910174615323,4198.79227836117,16824,5.25
2007-07-25,8811818,8965000,153182,5.32,-3591,8912,12503,-0.368488168639821,3915.22298215568,13233,5.32
2007-07-26,8825623,8965000,139377,5.28,9405,72067,62662,0.939731351643557,4733.18440904218,22638,5.28
2007-07-27,8830357,8965000,134643,5.25,-607,8676,9284,-0.065690406961263,3956.11692213303,22031,5.25
2007-07-30,8821437,8965000,143563,5.29,3910,12259,8349,0.363684462765638,4435.76638212895,25941,5.29
2007-07-31,8845417,8965000,119583,5.28,16319,53329,37010,1.62227009820004,4234.42293926474,42260,5.28
2007-08-01,8826563,8965000,138437,5.3,-20730,19775,40505,-2.08820738307015,3423.35806303953,21530,5.3
2007-08-02,8857261,8965000,107739,5.24,22434,86668,64234,2.04773770399108,4917.08422205939,43964,5.24
2007-08-03,8850812,8965000,114188,5.24,-18575,9509,28084,-1.73696536805161,4682.83152666662,25389,5.24
2007-08-06,8854656,8965000,110344,5.26,3443,11180,7737,0.267304110937943,4387.91059608173,28832,5.26
2007-08-07,8859490,8965000,105510,5.26,-5044,3961,9005,-0.483737916609162,4112.11292075204,23788,5.26
2007-08-08,8854501,8965000,110499,5.27,-3477,10041,13518,-0.332315410627022,4077.23490909811,20311,5.27
2007-08-09,8881386,8965000,83614,5.41,22968,86842,63874,1.92044907456886,4002.29640470457,43279,5.41
2007-08-10,8880324,8965000,84676,4.68,-2543,6947,9491,-0.303116391194867,4828.40217573422,40736,4.68
2007-08-13,8882050,8965000,82950,4.81,3751,11449,7698,0.297289114232073,4297.2652163536,44487,4.81
2007-08-14,8886333,8965000,78667,4.54,-1958,5539,7497,-0.188248876070011,4181.38991549423,42529,4.54
2007-08-15,8877493,8965000,87507,4.71,-36440,83829,120268,-2.95411311145031,4150.91040874512,6089,4.71
2007-08-16,8879330,8965000,85670,4.97,1785,92458,90673,0.25980044558052,4721.16640248996,7874,4.97
2007-08-17,8883865,8965000,81135,4.91,581,7159,6579,0.12520504587357,4222.67585694866,8455,4.91
2007-08-20,8884247,8965000,80753,5.03,4913,10844,5931,0.497072952399434,4156.7439396911,13368,5.03
2007-08-21,8888463,8965000,76537,4.89,-3295,3847,7142,-0.187445689567928,3932.45947304519,10073,4.89
2007-08-22,8883686,8965000,81314,4.77,-943,10971,11914,0.0150771013265701,3866.12950250748,9130,4.77
2007-08-23,8891829,8965000,73171,4.88,1600,85017,83416,0.225523290107444,4352.59841240638,10730,4.88
2007-08-24,8892432,8965000,72568,5.11,-2542,6346,8889,-0.155681124227368,4458.20207158795,8188,5.11
2007-08-27,8892059,8965000,72941,5.27,3899,11729,7830,0.37018432066958,4161.01632846043,12087,5.27
2007-08-28,8896548,8965000,68452,5.3,-5931,2949,8880,-0.487841186545814,3966.27664539147,6156,5.3
2007-08-29,8895817,8965000,69183,5,3181,9919,6738,0.293770143589051,3179.33939067711,9337,5
2007-08-30,8901661,8965000,63339,5,4815,87769,82953,0.444975590740886,3966.99903689554,14152,5
2007-08-31,8918493,8965000,46507,4.96,-9787,67091,76879,-0.937091742347167,4018.7709456365,4365,4.96
2007-09-04,8908540,8965000,56460,5.22,-853,22794,23647,-0.0702762740479363,4387.29355223605,3512,5.22
2007-09-05,8919501,8965000,45499,5.18,-2570,7852,10422,-0.238218582310874,3998.64215167385,942,5.18
2007-09-06,8922134,8965000,42866,4.98,5421,90071,84650,0.509347057946077,4107.47385803543,6363,4.98
2007-09-07,8922746,8965000,42254,4.86,-2918,7004,9922,-0.284111586009314,4457.93866806778,3445,4.86
2007-09-10,8922121,8965000,42879,5.07,2807,11863,9056,0.252399737227363,4319.69358885411,6252,5.07
2007-09-11,8929009,8965000,35991,5.06,-1571,6481,8052,-0.123034050832564,4348.76664827065,4681,5.06
2007-09-12,8924999,8965000,40001,5.18,-1094,11542,12636,-0.0799477226303522,4424.17968793212,3587,5.18
2007-09-13,8929209,8965000,35791,5.09,-337,81949,82286,-0.00777091235230245,4710.59784995156,3250,5.09
2007-09-14,8930178,8965000,34822,5.25,11821,20604,8783,1.16139193732567,4009.70057030348,15071,5.25
2007-09-17,8913930,8965000,51070,5.33,60360,95515,35156,4.21533495091787,4101.61356711822,75431,5.33
2007-09-18,8923595,8965000,41405,4.92,10344,17639,7295,0.620576236468653,4472.75242511244,85775,4.92
2007-09-19,8920280,8965000,44720,4.74,2758,15813,13054,0.0689462870277259,4323.41587054525,88533,4.74
2007-09-20,8903138,8965000,61862,4.77,-15600,68524,84124,-1.1998595741204,4454.0123544921,72933,4.77
2007-09-21,8904638,8965000,60362,4.76,5074,14515,9441,0.259841081433051,3983.74467401938,78007,4.76
2007-09-24,8907397,8965000,57603,4.74,9365,18613,9248,0.542494605286331,4662.81369241349,87372,4.74
2007-09-25,8913734,8965000,51266,4.82,335,10254,9919,-0.084862900745349,4491.34399547778,87707,4.82
2007-09-26,8908326,8965000,56674,4.88,-2569,11110,13679,-0.258998966748499,4070.29618515909,85138,4.88
2007-09-27,8886464,8965000,78536,4.93,-22256,59947,82203,-1.64937341629025,4268.5363596868,62882,4.93
2007-09-28,8921343,8965000,43657,4.58,7274,16146,8871,0.48212196963445,4375.14834542149,70156,4.58
2007-10-01,8976368,9815000,838632,4.92,-10312,62894,73206,-0.828106762788802,4632.10275779048,59844,4.92
2007-10-02,8983790,9815000,831210,4.78,-1121,5483,6604,-0.138497634199939,4690.56126976259,58723,4.78
2007-10-03,8975393,9815000,839607,4.68,-17404,11774,29178,-1.2962621350438,3962.99293694223,41319,4.68
2007-10-04,8963591,9815000,851409,4.74,-17714,59583,77297,-1.26670137152877,4407.60388302789,23605,4.74
2007-10-05,8968209,9815000,846791,4.77,-3663,7185,10848,-0.227115603457704,4600.33600636177,19942,4.77
2007-10-09,8968302,9815000,846698,4.91,3047,12481,9433,0.257280320301383,4296.09616691675,22989,4.91
2007-10-10,8964084,9815000,850916,4.52,-11815,5216,17032,-0.803550292597407,3619.1403754404,11174,4.52
2007-10-11,8956666,9815000,858334,4.75,-7256,62248,69504,-0.459047254707,4779.82372881798,3918,4.75
2007-10-12,8958091,9815000,856909,4.75,-369,6980,7349,-0.0245618872971453,4662.83825165651,3549,4.75
2007-10-15,8968180,9815000,846820,4.81,14843,27898,13054,1.15192113892203,3891.7145798009,18392,4.81
2007-10-16,8972644,9815000,842356,4.68,3829,11579,7750,0.275054630409371,4367.44393118715,22221,4.68
2007-10-17,8969715,9815000,845285,4.7,-2767,10102,12869,-0.230638175881848,3967.36252909935,19454,4.7
2007-10-18,8967276,9815000,847724,4.69,-7407,58178,65585,-0.587013794935646,4483.75632939933,12047,4.69
2007-10-19,8967849,9815000,847151,4.77,300,10298,9998,0.0172877336906783,4165.58134845965,12347,4.77
2007-10-22,8968559,9815000,846441,4.71,4642,13120,8478,0.352645929788065,4379.695357964,16989,4.71
2007-10-23,8972427,9815000,842573,4.67,-1069,5977,7046,-0.0992862369306398,4317.81075801887,15920,4.67
2007-10-24,8968540,9815000,846460,4.74,-5020,8610,13629,-0.392157916169166,4080.81569654969,10900,4.74
2007-10-25,8974199,9815000,840801,4.86,-190,64582,64772,-0.0239452706387189,4440.38859544651,10710,4.86
2007-10-26,8974582,9815000,840418,4.8,-996,6902,7897,-0.0792881309880594,4433.53534591663,9714,4.8
2007-10-29,8975092,9815000,839908,4.84,5208,13077,7869,0.409058371859017,3952.88578129953,14922,4.84
2007-10-30,8972946,9815000,842054,4.78,-4863,3563,8426,-0.396913225650448,4344.71743469027,10059,4.78
2007-10-31,8994639,9815000,820361,4.6,22818,60104,37286,1.68471647928811,2771.46161140508,32877,4.6
2007-11-01,8994615,9815000,820385,4.59,-5142,89606,94749,-0.44259413768874,3902.33476501619,27735,4.59
2007-11-02,8993331,9815000,821669,4.28,-21552,9358,30910,-1.58830010714912,4325.19766095715,6183,4.28
2007-11-05,8996268,9815000,818732,4.29,1259,12004,10745,0.0854808879814705,4372.11127697523,7442,4.29
2007-11-06,9000856,9815000,814144,4.22,-4748,4276,9023,-0.343248558176681,4514.06908919918,2694,4.22
2007-11-07,8999385,9815000,815615,4.39,2714,10512,7798,0.198539042125059,4028.58008307074,5408,4.39
2007-11-08,9025748,9815000,789252,4.58,17829,84635,66805,1.25045236252674,3959.10938958879,23237,4.58
2007-11-09,9026149,9815000,788851,4.49,-407,6658,7065,-0.0646578429786487,4784.21656819887,22830,4.49
2007-11-13,9026760,9815000,788240,4.61,2164,12147,9983,0.139375533364111,4249.43393083593,24994,4.61
2007-11-14,9025479,9815000,789521,4.6,-6454,8588,15043,-0.517323862098174,4155.57578718231,18540,4.6
2007-11-15,9027654,9815000,787346,4.54,-16006,139457,155463,-1.42075052556978,3742.82971339761,2534,4.54
2007-11-16,9030495,9815000,784505,4.51,3608,14071,10463,0.577589089276256,4214.93947865567,6142,4.51
2007-11-19,9035219,9815000,779781,4.51,2102,11349,9247,0.388107120525211,4175.16935499114,8244,4.51
2007-11-20,9040308,9815000,774692,4.51,-3930,4177,8107,-0.219123947486713,3756.70212135211,4314,4.51
2007-11-21,9035308,9815000,779692,4.5,-3656,11178,14834,-0.159066452782674,4216.61711499212,658,4.5
2007-11-23,9045574,9815000,769426,4.56,8590,91325,82735,1.11044171978908,4630.14537354484,9248,4.56
2007-11-26,9048756,9815000,766244,4.62,2687,9387,6700,0.47399788521018,4316.51539025239,11935,4.62
2007-11-27,9052522,9815000,762478,4.39,-4925,3096,8021,-0.394043755752161,4244.43770716452,7010,4.39
2007-11-28,9046058,9815000,768942,4.53,-6319,8237,14556,-0.516388075626337,4246.58872050392,691,4.53
2007-11-29,9054535,9815000,760465,4.55,9969,91896,81928,1.25118004094023,4387.61294215417,10660,4.55
2007-11-30,9065827,9815000,749173,4.66,-7195,50713,57909,-0.645955121663302,4402.29182268321,3465,4.66
2007-12-03,9071798,9815000,743202,4.52,4272,53760,49488,0.590489102321845,3616.88484748962,7737,4.52
2007-12-04,9080257,9815000,734743,4.5,-5268,4485,9752,-0.57460552833839,4339.06639910857,2469,4.5
2007-12-05,9080442,9815000,734558,4.31,1579,10831,9252,0.239877442294677,3364.71858147746,4048,4.31
2007-12-06,9084828,9815000,730172,4.49,-708,85909,86617,-0.0263712746567815,4402.79120414557,3340,4.49
2007-12-07,9082704,9815000,732296,4.41,-627,6648,7274,-0.0518523322363589,4226.32259565449,2713,4.41
2007-12-10,9084918,9815000,730082,4.46,4182,11790,7607,0.516109502835705,4091.84217992298,6895,4.46
2007-12-11,9088892,9815000,726108,4.29,-4379,3759,8138,-0.544851655521767,4630.0645752122,2516,4.29
2007-12-12,9091515,9815000,723485,4.28,3591,17548,13956,0.510005516759213,3838.40513290165,6107,4.28
2007-12-13,9088927,9815000,726073,4.3,-6145,80853,86998,-0.728853143871669,4560.54487859538,-38,4.3
2007-12-14,9088927,9815000,726073,4.24,8340,21013,12673,1.10700942454381,4270.64655777419,8302,4.24
2007-12-17,9059725,9815000,755275,4.31,54687,104051,49364,4.60889540644926,4337.42462429361,62989,4.31
2007-12-18,9069060,9815000,745940,4.16,-2465,5622,8086,-0.316237006554175,3998.99920297527,60524,4.16
2007-12-19,9063461,9815000,751539,3.98,-690,12012,12703,-0.151905965634713,4537.68669369743,59834,3.98
2007-12-20,9053872,9815000,761128,4.37,-15868,67534,83402,-1.39286146675722,4078.3436760139,43966,4.37
2007-12-21,9055811,9815000,759189,4.28,943,11132,10189,0.00782281812169631,3783.92617171845,44909,4.28
2007-12-24,9058373,9815000,756627,4,12341,17409,5068,0.931763149379662,4385.79615720335,57250,4
2007-12-26,9055747,9815000,759253,4.26,-6267,5414,11681,-0.605741669362385,4551.09749008805,50983,4.26
2007-12-27,9039996,9815000,775004,4.15,-20754,63624,84378,-1.68972041798942,4432.52379173375,30229,4.15
2007-12-28,9036642,9815000,778358,4.01,1997,13268,11271,0.115590491853219,3902.51509489368,32226,4.01
2007-12-31,9144715,9815000,670285,3.06,19669,65252,45583,1.55446133184328,3957.5247927108,51895,3.06
2008-01-02,9126339,9815000,688661,4.11,-11095,25834,36930,-0.917232278486357,4015.4843800405,40800,4.11
2008-01-03,9110277,9815000,704723,4.25,-36235,67356,103591,-2.72114198967698,4056.54692784119,4565,4.25
2008-01-04,9113017,9815000,701983,4.18,1865,10802,8937,0.142094717482246,4366.40063847951,6430,4.18
2008-01-07,9115325,9815000,699675,4.27,3837,12126,8289,0.274380910968894,4066.8816399074,10267,4.27
2008-01-08,9117101,9815000,697899,4.27,-436,8030,8467,-0.0411323867754057,4219.96267605551,9831,4.27
2008-01-09,9112437,9815000,702563,4.26,-3012,10424,13437,-0.200417239722623,4223.71976987636,6819,4.26
2008-01-10,9113851,9815000,701149,4.26,-3891,69528,73419,-0.261188725861182,5002.31603851719,2928,4.26
2008-01-11,9113812,9815000,701188,4.23,-37,9269,9306,0.039704122677127,4233.14126260941,2891,4.23
2008-01-14,9115781,9815000,699219,4.24,8261,16488,8227,0.648554793649436,4491.70161060707,11152,4.24
2008-01-15,9110713,9815000,704287,4.24,-5890,33550,39440,-0.46535369664294,4392.41287082371,5262,4.24
2008-01-16,9106972,9815000,708028,4.22,7538,20193,12655,0.573819515939788,4259.90935172577,12800,4.22
2008-01-17,9103801,9815000,711199,4.23,-9486,61462,70949,-0.723994786821925,4714.2432495442,3314,4.23
2008-01-18,9104962,9815000,710038,4.17,9051,15702,6651,0.680915457238959,4581.90245543389,12365,4.17
2008-01-22,9107819,9815000,707181,3.68,15588,22673,7085,1.12879760586556,3801.38932778906,27953,3.68
2008-01-23,9109092,9815000,705908,3.43,11262,25842,14580,0.793266886173706,4213.48567263401,39215,3.43
2008-01-24,9111976,9815000,703024,3.47,1311,71698,70387,0.0450008422151262,3961.05003234372,40526,3.47
2008-01-25,9119118,9815000,695882,3.6,-7825,12228,20053,-0.637177416129446,4008.55263779834,32701,3.6
2008-01-28,9120096,9815000,694904,3.5,6389,14465,8077,0.40912250160794,4084.5656203742,39090,3.5
2008-01-29,9124786,9815000,690214,3.47,-2335,6151,8485,-0.226348011930049,4269.55503304018,36755,3.47
2008-01-30,9118449,9815000,696551,3.26,2934,10047,7113,0.154359280613745,3639.61612924412,39689,3.26
2008-01-31,9155842,9815000,659158,3.22,25503,131913,106410,1.75704378989171,4188.32082606663,65192,3.22
2008-02-01,9128790,9815000,686210,3.12,-47995,23076,71071,-3.07141278605259,4335.45252091533,17197,3.12
2008-02-04,9137370,9815000,677630,2.82,6880,14680,7800,0.404289845711401,3729.42796956299,24077,2.82
2008-02-05,9142702,9815000,672298,2.71,-5453,4082,9535,-0.369167664443146,4619.7565313261,18624,2.71
2008-02-06,9141279,9815000,673721,2.94,3440,11946,8507,0.186954715005347,3758.41675749455,22064,2.94
2008-02-07,9159587,9815000,655413,3.03,13623,91644,78021,0.809531799338377,4699.20100368306,35687,3.03
2008-02-08,9162286,9815000,652714,3.05,-19974,7380,27354,-1.24911777980195,3856.97230834,15713,3.05
2008-02-11,9163974,9815000,651026,2.88,1876,12803,10927,0.0977932718848482,4520.72491965684,17589,2.88
2008-02-12,9168883,9815000,646117,2.91,-3978,4265,8243,-0.266131632110034,4431.66512285293,13611,2.91
2008-02-13,9162205,9815000,652795,3.02,-5904,7804,13708,-0.363393853160587,4082.47575707963,7707,3.02
2008-02-14,9209438,9815000,605562,3.03,42632,111844,69212,2.81697622643524,4279.65760646473,50339,3.03
2008-02-15,9206562,9815000,608438,2.97,-52332,75017,127348,-2.93061549811175,4326.08563271548,-1993,2.97
2008-02-19,9209381,9815000,605619,2.94,14396,24082,9686,0.890059867605791,3842.52673772854,12403,2.94
2008-02-20,9212283,9815000,602717,3,-10444,6362,16805,-0.539548230965077,3455.00346036167,1959,3
2008-02-21,9232956,9815000,582044,3.01,22595,97101,74506,1.29751969908198,4206.2527495215,24554,3.01
2008-02-22,9237267,9815000,577733,2.97,-18990,7270,26260,-0.987867112450004,4045.08787119814,5564,2.97
2008-02-25,9238660,9815000,576340,3,5545,15034,9489,0.364886451572294,4432.86308282933,11109,3
2008-02-26,9245154,9815000,569846,2.85,-8249,3977,12226,-0.42781267460384,4432.27590996584,2860,2.85
2008-02-27,9248744,9815000,566256,2.93,3976,19109,15133,0.260598781460048,3948.30036208067,6836,2.93
2008-02-28,9261395,9815000,553605,3.06,10481,95913,85433,0.64901886793567,4058.75012624596,17317,3.06
2008-02-29,9275683,9815000,539317,3.01,-11370,59670,71040,-0.600435340677747,4394.94926311975,5947,3.01
2008-03-03,9286371,9815000,528629,3.1,14911,58960,44049,0.869290663623554,3745.35275756122,20858,3.1
2008-03-04,9297542,9815000,517458,2.9,-4793,4560,9352,-0.301379467098694,4080.95502128047,16065,2.9
2008-03-05,9298525,9815000,516475,2.93,1820,12024,10204,0.0976088924243678,4243.10116027761,17885,2.93
2008-03-06,9312774,9815000,502226,2.99,9518,97603,88084,0.541715274071597,4511.87791851545,27403,2.99
2008-03-07,9311854,9815000,503146,2.96,-12068,7882,19950,-0.728067294595868,4178.26666803429,15335,2.96
2008-03-10,9314891,9815000,500109,2.99,4827,15489,10662,0.260593738732122,4087.53163640007,20162,2.99
2008-03-11,9320923,9815000,494077,2.95,-4455,4554,9009,-0.282779871130177,4006.3619569578,15707,2.95
2008-03-12,9315393,9815000,499607,2.97,-4821,10336,15157,-0.285611934399118,4068.99707183907,10886,2.97
2008-03-13,9326162,9815000,488838,2.98,4811,90026,85215,0.270110689307789,4086.53296866283,15697,2.98
2008-03-14,9326443,9815000,488557,2.99,752,18199,17447,0.0393216340564898,3947.46414350855,16449,2.99
2008-03-17,9297727,9815000,517273,2.69,13399,63993,50594,0.755402737158313,4497.37012915008,29848,2.69
2008-03-18,9307859,9815000,507141,2.16,-3828,4847,8676,-0.247910664288295,4392.12486477534,26020,2.16
2008-03-19,9301796,9815000,513204,2.08,-3283,11636,14919,-0.189423088493852,3981.27952741287,22737,2.08
2008-03-20,9310737,9815000,504263,2.22,1879,83395,81516,0.135634238886781,4436.53812584356,24616,2.22
2008-03-21,9311179,9815000,503821,2.08,-8102,8906,17008,-0.452270609351301,3762.12001308533,16514,2.08
2008-03-24,9314603,9815000,500397,2.08,2758,12350,9592,0.186898989830102,3977.43603971202,19272,2.08
2008-03-25,9319572,9815000,495428,2.42,-5313,3939,9252,-0.283331585092149,4228.26344884719,13959,2.42
2008-03-26,9313195,9815000,501805,2.3,-4907,10358,15265,-0.254706060003933,4318.53612432996,9052,2.3
2008-03-27,9331627,9815000,483373,2.27,10714,95424,84710,0.673987310579788,4423.77279583913,19766,2.27
2008-03-28,9327283,9815000,487717,2.09,-5086,9493,14579,-0.237404942957877,4269.72427867105,14680,2.09
2008-03-31,9358135,9815000,456865,2.51,26379,65431,39052,1.74066220387743,3543.37777007033,41059,2.51
2008-04-01,9367153,9815000,447847,2.38,2261,46824,44564,0.120431281107208,3944.80396358439,43320,2.38
2008-04-02,9375410,9815000,439590,2.18,2995,12139,9144,0.156085677893377,3889.904639138,46315,2.18
2008-04-03,9357940,9815000,457060,2.19,-36981,72987,109968,-2.30587695948978,4362.50051157499,9334,2.19
2008-04-04,9359109,9815000,455891,2.26,-6192,10518,16710,-0.341217835239938,3920.30265868776,3142,2.26
2008-04-07,9362051,9815000,452949,2.24,2539,14073,11533,0.180457230180794,4068.05353088658,5681,2.24
2008-04-08,9367091,9815000,447909,2.23,-2019,8004,10023,-0.108087024454915,4119.0899560307,3662,2.23
2008-04-09,9358376,9815000,456624,2.2,-5064,10215,15280,-0.303167281708889,4462.04233427442,-1402,2.2
2008-04-10,9363537,9815000,451463,2.3,1047,85976,84929,0.0808596404674181,4168.06976480549,-355,2.3
2008-04-11,9363669,9815000,451331,2.37,-806,12435,13242,0.0349152398590411,4187.44384913787,-1161,2.37
2008-04-14,9365558,9815000,449442,2.32,12073,20320,8246,1.04977574122127,4491.17676275224,10912,2.32
2008-04-15,9330307,9815000,484693,2.32,5379,75052,69673,0.480534610614128,4031.73596891164,16291,2.32
2008-04-16,9322025,9815000,492975,2.35,-1030,39706,40735,-0.125464868132489,3852.42904902579,15261,2.35
2008-04-17,9289488,9815000,525512,2.37,-7231,94186,101417,-0.661812436182987,4318.40977446082,8030,2.37
2008-04-18,9293720,9815000,521280,2.32,3688,19766,16078,0.358135569591673,4220.04182434326,11718,2.32
2008-04-21,9276377,9815000,538623,2.28,-847,28331,29178,-0.0855566197130213,4108.62810175993,10871,2.28
2008-04-22,9263014,9815000,551986,1.99,18809,49330,30522,1.78291000243348,3706.27157109812,29680,1.99
2008-04-23,9263577,9815000,551423,2.18,14933,29540,14607,1.34381595319743,3487.2984017513,44613,2.18
2008-04-24,9255059,9815000,559941,2.26,2890,80102,77213,0.207317724787795,3975.41443931142,47503,2.26
2008-04-25,9256891,9815000,558109,2.28,6779,22798,16019,0.548789344099282,4105.91074250243,54282,2.28
2008-04-28,9259649,9815000,555351,2.29,19917,28571,8654,1.79500644092225,4037.86259898154,74199,2.29
2008-04-29,9260249,9815000,554751,2.21,18876,29232,10357,1.58931853075013,4006.11409152132,93075,2.21
2008-04-30,9298567,9815000,516433,2.37,42554,83072,40517,3.18145254753816,3771.69336259306,135629,2.37
2008-05-01,9267240,9815000,547760,2.16,-38135,73254,111389,-2.85115118572164,4027.94921903332,97494,2.16
2008-05-02,9267837,9815000,547163,1.88,-27682,12361,40042,-1.99062745476647,3813.9762424244,69812,1.88
2008-05-05,9272942,9815000,542058,1.85,123,13368,13245,-0.0769050291727273,3748.64150747805,69935,1.85
2008-05-06,9278627,9815000,536373,1.91,-5910,6486,12397,-0.487629864968203,4439.17073649773,64025,1.91
2008-05-07,9280413,9815000,534587,2.01,1164,12695,11531,-0.0132910714921649,4141.57786692195,65189,2.01
2008-05-08,9285248,9815000,529752,1.99,-5740,71089,76829,-0.468207968500635,4527.67861541038,59449,1.99
2008-05-09,9285754,9815000,529246,1.97,-15872,6909,22781,-1.11522297759281,4504.417143117,43577,1.97
2008-05-12,9287202,9815000,527798,1.88,3458,11949,8490,0.205947071852331,4121.86456065082,47035,1.88
2008-05-13,9291517,9815000,523483,1.93,-5748,2946,8694,-0.416368265998235,4526.45506834148,41287,1.93
2008-05-14,9285396,9815000,529604,2.03,-5664,10309,15973,-0.406067508433043,4274.97868666366,35623,2.03
2008-05-15,9272612,9815000,542388,2.03,-33000,156218,189218,-2.07338383230098,4268.39703937137,2623,2.03
2008-05-16,9273045,9815000,541955,1.91,-3011,14628,17639,-0.165836119351262,4467.42828430371,-388,1.91
2008-05-19,9277447,9815000,537553,1.95,1762,12418,10656,0.14159445650097,4447.43378645716,1374,1.95
2008-05-20,9299752,9815000,515248,1.99,11927,21580,9653,0.760535191543202,3523.90501421454,13301,1.99
2008-05-21,9294105,9815000,520895,2.03,-4283,11936,16220,-0.272759986094518,3836.82594876431,9018,2.03
2008-05-22,9312994,9815000,502006,2.05,9418,84083,74665,0.602836096870577,4423.40696990776,18436,2.05
2008-05-23,9314349,9815000,500651,1.99,-928,7477,8405,-0.063784590193718,4194.30296713992,17508,1.99
2008-05-27,9313976,9815000,501024,2.23,4149,12104,7955,0.307223300326407,3812.09977592236,21657,2.23
2008-05-28,9311420,9815000,503580,2.08,-12052,5849,17901,-0.738109522661984,4305.92905190041,9605,2.08
2008-05-29,9311678,9815000,503322,2.01,4000,84510,80510,0.317090653956479,4033.32613852172,13605,2.01
2008-05-30,9324005,9815000,490995,1.98,-4783,27821,32604,-0.339818364225125,3952.48282537959,8822,1.98
2008-06-02,9331808,9815000,483192,2.06,20306,78636,58331,1.36883110899613,3744.4376638227,29128,2.06
2008-06-03,9330910,9815000,484090,1.95,-27030,4247,31277,-1.79522483816452,4454.55970638825,2098,1.95
2008-06-04,9331407,9815000,483593,1.98,435,10837,10402,0.0308741757605579,3793.91860452722,2533,1.98
2008-06-05,9342440,9815000,472560,1.98,943,90126,89183,0.0548024667374372,4481.63406945945,3476,1.98
2008-06-06,9340750,9815000,474250,2.01,-2190,7244,9434,-0.1488778537915,4492.8049957859,1286,2.01
2008-06-09,9342425,9815000,472575,2.02,3358,11816,8459,0.21427691081255,3942.77791473482,4644,2.02
2008-06-10,9346840,9815000,468160,1.96,-3922,5094,9016,-0.246444566215847,4216.76989022911,722,1.96
2008-06-11,9363654,9815000,451346,1.95,18016,32937,14920,1.18629035280792,3418.84828874119,18738,1.95
2008-06-12,9350445,9815000,464555,2.01,-19222,76437,95658,-1.21951954594416,4583.1238604946,-484,2.01
2008-06-13,9350603,9815000,464397,2.02,6152,19010,12857,0.402473074754089,3895.16975810355,5668,2.02
2008-06-16,9322055,9815000,492945,2.06,30822,85182,54359,1.86673610355102,3904.09794064631,36490,2.06
2008-06-17,9331957,9815000,483043,1.87,6159,15481,9322,0.331123747017954,4145.00722805581,42649,1.87
2008-06-18,9327486,9815000,487514,1.84,268,15821,15553,-0.00394873672110196,4279.04441815456,42917,1.84
2008-06-19,9305310,9815000,509690,1.94,-30087,73841,103927,-1.7797252304916,4506.42363813581,12830,1.94
2008-06-20,9305837,9815000,509163,1.99,6989,15123,8134,0.465656438589053,3490.93423116924,19819,1.99
2008-06-23,9308558,9815000,506442,1.98,13254,20694,7440,0.830283363378741,4557.66242995209,33073,1.98
2008-06-24,9314604,9815000,500396,1.93,-2368,7612,9980,-0.078718903711326,4511.20223118349,30705,1.93
2008-06-25,9306316,9815000,508684,1.97,-5357,11338,16695,-0.229644396342135,4108.1817979394,25348,1.97
2008-06-26,9303919,9815000,511081,2.05,-9123,70393,79515,-0.429692354209949,4507.77252167219,16225,2.05
2008-06-27,9298929,9815000,516071,1.99,-1091,9988,11079,0.0739002988713947,3982.21367089147,15134,1.99
2008-06-30,9427901,9815000,387099,2.47,33100,73277,40177,2.47945856167252,4190.17850616081,48234,2.47
2008-07-01,9403473,9815000,411527,2.11,-37138,15194,52332,-2.41837198496438,4242.00752003105,11096,2.11
2008-07-02,9409080,9815000,405920,1.95,289,12098,11809,0.108938508463621,4008.3184459678,11385,1.95
2008-07-03,9427541,9815000,387459,1.92,-2815,93795,96610,-0.0950161338863282,4890.93441035036,8570,1.92
2008-07-07,9429117,9815000,385883,1.99,4919,15746,10827,0.41151517898572,3950.0336112695,13489,1.99
2008-07-08,9435395,9815000,379605,1.97,-6702,3734,10435,-0.396557742052161,4547.1444445065,6787,1.97
2008-07-09,9428845,9815000,386155,1.99,-7273,8835,16108,-0.416858938601649,4548.54101455743,-486,1.99
2008-07-10,9437992,9815000,377008,2.01,4551,84996,80446,0.375306276601144,4250.21099644308,4065,2.01
2008-07-11,9436838,9815000,378162,1.97,-3262,7508,10770,-0.16390793780486,4374.50179439972,803,1.97
2008-07-14,9434095,9815000,380905,2.06,-600,13591,14191,-0.039585468950593,4368.6658480666,203,2.06
2008-07-15,9445385,9815000,369615,2.16,700,20174,19473,0.0490225695482881,4352.47414113012,903,2.16
2008-07-16,9440427,9815000,374573,1.95,438,15677,15239,0.0322237426724276,4164.89409076649,1341,1.95
2008-07-17,9453353,9815000,361647,2.03,2326,87242,84916,0.190328566936785,3943.77474363983,3667,2.03
2008-07-18,9453716,9815000,361284,1.96,1119,8294,7176,0.090914899873666,4295.43691108866,4786,1.96
2008-07-21,9456000,9815000,359000,1.98,4932,11532,6600,0.384062392879405,4125.04021442639,9718,1.98
2008-07-22,9468515,9815000,346485,1.97,3866,11799,7932,0.295298227161117,4252.5874285312,13584,1.97
2008-07-23,9462370,9815000,352630,2.04,-894,13138,14032,-0.0499615269370054,3665.12475934821,12690,2.04
2008-07-24,9475646,9815000,339354,2.06,5910,80235,74324,0.427424485116788,4313.25077936749,18600,2.06
2008-07-25,9476237,9815000,338763,2.13,-2355,7749,10104,-0.182131544877032,4374.21479892596,16245,2.13
2008-07-28,9473231,9815000,341769,2,1032,12945,11913,0.0618407206814443,4142.33896852475,17277,2
2008-07-29,9473389,9815000,341611,2.05,-7693,5206,12898,-0.557763598717885,3889.39133892459,9584,2.05
2008-07-30,9468396,10615000,1146604,2.03,1000,9214,8214,0.0646891002537364,3918.36351277596,10584,2.03
2008-07-31,9520220,10615000,1094780,2.09,45889,168586,122697,3.14556184244762,4535.39770739962,56473,2.09
2008-08-01,9491375,10615000,1123625,2.04,-46368,20382,66750,-2.90020231540231,4477.44842401144,10105,2.04
2008-08-04,9499679,10615000,1115321,1.97,4907,13736,8829,0.284219043083953,3978.23036862787,15012,1.97
2008-08-05,9504386,10615000,1110614,1.97,-4787,4198,8985,-0.306567795109836,4593.21110902422,10225,1.97
2008-08-06,9503933,10615000,1111067,2.01,4103,11424,7321,0.234182495530235,4096.96954312594,14328,2.01
2008-08-07,9505878,10615000,1109122,1.96,-3735,82384,86119,-0.223213101983568,4587.88908085777,10593,1.96
2008-08-08,9507962,10615000,1107038,2.01,-3537,7207,10745,-0.239908065390487,3899.99466534027,7056,2.01
2008-08-11,9509878,10615000,1105122,1.99,2465,11454,8989,0.152783423612486,4275.02908140113,9521,1.99
2008-08-12,9514141,10615000,1100859,1.95,-4425,3557,7982,-0.247750308325338,4273.6199409868,5096,1.95
2008-08-13,9533481,10615000,1081519,1.98,19908,33265,13357,1.35510138996149,3556.63878542649,25004,1.98
2008-08-14,9527585,10615000,1087415,2.09,-10406,88029,98434,-0.642322482070338,4224.43047124097,14598,2.09
2008-08-15,9541236,10615000,1073764,2.08,-14578,77313,91890,-0.982457018834031,4128.42529983881,20,2.08
2008-08-18,9542567,10615000,1072433,1.91,10499,18171,7672,0.736640060073896,4386.46385721288,10519,1.91
2008-08-19,9549077,10615000,1065923,1.94,-4259,2923,7182,-0.248957320398483,4331.67865285357,6260,1.94
2008-08-20,9542747,10615000,1072253,1.98,-3690,10805,14496,-0.207112157389204,4466.13526360959,2570,1.98
2008-08-21,9552676,10615000,1062324,2.01,2549,92317,89768,0.211999944723699,3721.77386139954,5119,2.01
2008-08-22,9552833,10615000,1062167,2.02,-2965,7431,10396,-0.182139030958295,4129.4223381516,2154,2.02
2008-08-25,9555835,10615000,1059165,2.01,2822,11866,9044,0.214268490242515,3877.69259681538,4976,2.01
2008-08-26,9569993,10615000,1045007,1.88,4669,14171,9502,0.422668373330686,3805.94855821486,9645,1.88
2008-08-27,9563211,10615000,1051789,1.98,-6466,8217,14683,-0.521828188776452,4436.56727340278,3179,1.98
2008-08-28,9583948,10615000,1031052,1.99,18247,110797,92550,1.45587332527817,4353.86500098767,21426,1.99
2008-08-29,9580508,10615000,1034492,1.94,-19638,11298,30937,-1.52716746877536,3715.31792429281,1788,1.94
2008-09-02,9602721,10615000,1012279,1.96,29590,82845,53254,2.14745445477456,3730.18166660459,31378,1.96
2008-09-03,9602635,10615000,1012365,2.01,-24810,6187,30997,-1.75832738319904,3666.63682531147,6568,2.01
2008-09-04,9602822,10615000,1012178,1.99,-1744,92135,93879,-0.133473313772754,4516.89956243692,4824,1.99
2008-09-05,9604495,10615000,1010505,1.97,-4298,7491,11789,-0.299414710244584,4704.34261352177,526,1.97
2008-09-08,9603746,10615000,1011254,1.92,955,11540,10585,0.0667623689847485,4507.97017109608,1481,1.92
2008-09-09,9627726,10615000,987274,1.96,15132,24219,9087,1.03298838225694,4231.91565725957,16613,1.96
2008-09-10,9619825,10615000,995175,2.12,-5001,8973,13974,-0.369032648332696,3770.16192433618,11612,2.12
2008-09-11,9616831,10615000,998169,2,-6832,86927,93758,-0.48306145383938,4488.15683736937,4780,2
2008-09-12,9618103,10615000,996897,2.1,7778,14802,7024,0.525841047427011,4121.71446865393,12558,2.1
2008-09-15,9569079,10615000,1045921,2.64,3549,80341,76792,0.227153053480011,4137.44775212779,16107,2.64
2008-09-16,9574849,10615000,1040151,1.98,15927,23197,7270,1.05464304343937,3917.17032577231,32034,1.98
2008-09-17,9582272,10615000,1032728,2.8,440,14284,13844,-0.0022145282439201,3709.6203831796,32474,2.8
2008-09-18,9599518,10615000,1015482,2.16,14680,133245,118565,0.937943409225094,4272.10074666815,47154,2.16
2008-09-19,9661942,10615000,953058,1.48,66889,78383,11493,3.57358744127844,3674.6145482991,114043,1.48
2008-09-22,9720825,10615000,894175,1.51,69839,80580,10741,3.1348336034533,3909.95512447353,183882,1.51
2008-09-23,9726596,10615000,888404,1.46,-1536,10202,11738,-0.270228119563762,3644.12659457676,182346,1.46
2008-09-24,9723174,10615000,891826,1.19,-5938,10934,16872,-0.482930446503682,3794.18809517758,176408,1.19
2008-09-25,9783663,10615000,831337,1.23,51931,151792,99860,2.09005744682508,3741.50940596447,228339,1.23
2008-09-26,9823642,10615000,791358,1.08,35738,47626,11888,1.39982286449651,3959.30402363689,264077,1.08
2008-09-29,9879947,10615000,735053,1.56,66313,75379,9066,2.61873492073849,4143.45158242172,330390,1.56
2008-09-30,9959850,10615000,655150,2.03,36131,71760,35628,1.20473044210886,4239.0905669637,366521,2.03
2008-09-30,9959850,10615000,655150,2.03,36131,71760,35628,1.20473044210886,4239.0905669637,366521,2.03
2008-10-02,10082964,10615000,532036,0.67,14825,138350,123525,0.245360117039988,3510.60572126218,381346,0.67
2008-10-03,10120503,11315000,1194497,1.1,21667,54062,32395,0.527009773758579,3754.23124715871,403013,1.1
2008-10-06,10122209,11315000,1192791,1.96,-781,11364,12146,-0.467069300237052,3495.81896245414,402232,1.96
2008-10-07,10158750,11315000,1156250,2.97,23561,34138,10578,0.578521629433211,3982.77945411979,425793,2.97
2008-10-08,10179742,11315000,1135258,2.24,23164,39112,15949,0.536953517659335,3732.88820220466,448957,2.24
2008-10-09,10200700,11315000,1114300,1.4,10076,128381,118305,-0.0564448028443912,4494.85710871634,459033,1.4
2008-10-10,10228709,11315000,1086291,0.79,25549,36795,11246,0.621683978307901,3828.16349188941,484582,0.79
2008-10-14,10229031,11315000,1085969,1.1,1906,12512,10606,-0.441725307095703,4262.38688431579,486488,1.1
2008-10-15,10260756,11315000,1054244,1.04,22264,62198,39934,0.433216967002708,4137.22437081245,508752,1.04
2008-10-16,10265692,11315000,1049308,0.83,9102,141219,132117,-0.162500448073991,4359.09450587058,517854,0.83
2008-10-17,10268833,11315000,1046167,0.6,-10143,7436,17579,-1.02276963270469,3975.16212337847,507711,0.6
2008-10-20,10399039,11315000,915961,0.7,131294,141306,10012,3.99324309672146,4116.02272069793,639005,0.7
2008-10-21,10401617,11315000,913383,0.67,-3865,6344,10209,-0.676670676607104,3631.38932484131,635140,0.67
2008-10-22,10429623,11315000,885377,0.81,32000,46935,14934,0.531346282516785,3659.44315436106,667140,0.81
2008-10-23,10456850,11315000,858150,0.93,20982,152153,131171,0.13526605951964,3822.60653313192,688122,0.93
2008-10-24,10456774,11315000,858226,0.95,-3943,6784,10727,-0.71786525201555,4338.14531140407,684179,0.95
2008-10-27,10457810,11315000,857190,0.92,2345,11367,9022,-0.511138518351191,4146.58477133569,686524,0.92
2008-10-28,10460169,11315000,854831,0.67,-119990,3356,123347,-3.70454832559385,4077.85375885053,566534,0.67
2008-10-29,10459353,11315000,855647,0.36,140,9925,9784,-0.391274851834098,4652.94724102668,566674,0.36
2008-10-30,10463219,11315000,851781,0.3,2399,125900,123501,-0.309410458945821,4521.66751338345,569073,0.3
2008-10-31,10504702,11315000,810298,0.22,18516,78420,59903,0.113512776268026,3459.55490427805,587589,0.22
2008-11-03,10487025,11315000,827975,0.23,-21267,25307,46573,-0.993939566148951,4243.70194289829,566322,0.23
2008-11-04,10497073,11315000,817927,0.23,-5627,5407,11035,-0.552402156370589,4223.83312363891,560695,0.23
2008-11-05,10497877,11315000,817123,0.23,-42,10780,10822,-0.394436677841545,3780.99259034635,560653,0.23
2008-11-06,10555241,11315000,759759,0.23,50217,168165,117948,0.982054883121836,4182.48340777931,610870,0.23
2008-11-07,10552516,11315000,762484,0.27,-5497,6620,12117,-0.56481167316563,4664.90542436328,605373,0.27
2008-11-10,10552809,11315000,762191,0.29,-2949,11001,13950,-0.49751266832383,4193.26569027129,602424,0.29
2008-11-12,10549249,11315000,765751,0.35,-14802,5852,20655,-0.804916434746095,4178.15958078909,587622,0.35
2008-11-13,10509300,11315000,805700,0.35,-45043,98534,143577,-1.55552899924704,4527.40254941445,542579,0.35
2008-11-14,10548344,11315000,766656,0.34,-558,50052,50610,-0.355084294712812,4360.31610502201,542021,0.34
2008-11-17,10549653,11315000,765347,0.37,-11830,87324,99154,-0.645029040903098,4119.08435377234,530191,0.37
2008-11-18,10591419,11315000,723581,0.38,27655,38038,10383,0.394832476805967,4238.03566235548,557846,0.38
2008-11-19,10583406,11315000,731594,0.38,-6080,10280,16360,-0.462905167003392,3672.89339719285,551766,0.38
2008-11-20,10586259,11315000,728741,0.49,-6893,117451,124344,-0.44705092260631,4826.86020856373,544873,0.49
2008-11-21,10586345,11315000,728655,0.57,-7876,6837,14713,-0.469386086903083,4834.23032620762,536997,0.57
2008-11-24,10585359,11315000,729641,0.62,-14454,10738,25192,-0.645740420241356,4342.34359698605,522543,0.62
2008-11-25,10589531,11315000,725469,0.59,-44814,6370,51184,-1.41594967974246,3857.33574555914,477729,0.59
2008-11-26,10579163,11315000,735837,0.53,-6730,12923,19653,-0.332618658302793,4060.51550670093,470999,0.53
2008-11-28,10595725,11315000,719275,0.52,4088,144292,140204,0.013685471578408,4192.96174218518,475087,0.52
2008-12-01,10615759,11315000,699241,0.52,11241,83472,72231,0.242491158607846,4221.12792983108,486328,0.52
2008-12-02,10619863,11315000,695137,0.47,4045,6105,2059,0.0388594996582364,4357.50671574672,490373,0.47
2008-12-03,10610702,11315000,704298,0.36,-20711,10257,30967,-0.658035682024953,4423.35685311506,469662,0.36
2008-12-04,10588660,11315000,726340,0.2,-30954,101993,132947,-0.926490302821533,4830.99459632098,438708,0.2
2008-12-05,10588118,11315000,726882,0.12,-6202,6830,13031,-0.186180740719593,4029.61755442382,432506,0.12
2008-12-08,10588993,11315000,726007,0.12,2321,11513,9192,0.0786265728796424,4595.6708782754,434827,0.12
2008-12-09,10591252,11315000,723748,0.13,-4379,4565,8944,-0.10785453698449,4856.25672641564,430448,0.13
2008-12-10,10583644,11315000,731356,0.11,-6339,9135,15473,-0.143170668223345,4304.28276670043,424109,0.11
2008-12-11,10533057,11315000,781943,0.14,-34470,111322,145792,-0.939572620191441,4607.66983796737,389639,0.14
2008-12-12,10532305,11315000,782695,0.15,-1899,12562,14461,0.0332489813912217,4318.07577102182,387740,0.15
2008-12-15,10591043,11315000,723957,0.18,74272,106388,32116,2.10334732717006,4292.1930022139,462012,0.18
2008-12-16,10566065,11315000,748935,0.17,3382,13199,9817,0.123488024254806,4806.63311922776,465394,0.17
2008-12-17,10591137,11315000,723863,0.12,-4715,9824,14540,-0.00890444846990777,4226.28694929459,460679,0.12
2008-12-18,10533941,11315000,781059,0.11,-68081,111885,179966,-2.03016352713787,4341.64496905281,392598,0.11
2008-12-19,10533732,11315000,781268,0.11,-635,11621,12256,0.208599485143781,3804.16231053837,391963,0.11
2008-12-22,10503160,11315000,811840,0.11,6080,15974,9894,0.449327878115698,4139.81622425862,398043,0.11
2008-12-23,10537566,11315000,777434,0.11,-8995,6168,15163,-0.0544953071632385,4134.64368045007,389048,0.11
2008-12-24,10522445,11315000,792555,0.11,-6122,14752,20874,0.0495489526520056,4002.01675190643,382926,0.11
2008-12-26,10488763,11315000,826237,0.09,-33240,91368,124607,-1.16949938346815,4556.30538610271,349686,0.09
2008-12-29,10490284,11315000,824716,0.1,-54,14896,14950,0.225851263319741,3923.5053653063,349632,0.1
2008-12-30,10489206,11315000,825794,0.09,-3559,8341,11900,0.084869335424017,4608.24345525029,346073,0.09
2008-12-31,10640274,11315000,674726,0.14,-6796,91402,98198,-0.0251036196579081,4985.97349420558,339277,0.14
2009-01-02,10568470,11315000,746530,0.08,-82886,143910,226795,-2.85730887913499,4811.03270461973,256391,0.08
2009-01-05,10576196,11315000,738804,0.11,5774,16324,10550,0.501754877700507,4335.0729603351,262165,0.11
2009-01-06,10579168,11315000,735832,0.09,-4032,6038,10070,0.133949598731694,4094.90225584453,258133,0.09
2009-01-07,10576572,11315000,738428,0.11,3429,13623,10194,0.4920194043647,4368.84019588069,261562,0.11
2009-01-08,10549122,11315000,765878,0.1,-31826,119571,151397,-0.898166773230688,4801.89768307595,229736,0.1
2009-01-09,10550610,11315000,764390,0.09,-22269,8641,30910,-0.495056388424754,4351.72884929401,207467,0.09
2009-01-12,10550805,11315000,764195,0.1,3926,14857,10932,0.530760370403528,4584.38466582874,211393,0.1
2009-01-13,10554974,11315000,760026,0.1,-2546,7741,10287,0.236988703911947,4670.30328745633,208847,0.1
2009-01-14,10547079,11315000,767921,0.15,-3398,12902,16301,0.205222000146821,4256.48929861292,205449,0.15
2009-01-15,10568724,11315000,746276,0.18,13773,210239,196465,0.872867248805601,4714.96853387134,219222,0.18
2009-01-16,10569948,11315000,745052,0.19,-14349,18100,32449,-0.229961481791377,4817.9581398453,204873,0.19
2009-01-20,10568142,11315000,746858,0.2,3999,13389,9391,0.521490268966841,4116.52348729223,208872,0.2
2009-01-21,10566369,11315000,748631,0.23,12303,36203,23900,0.838252917038115,4205.35933453251,221175,0.23
2009-01-22,10560027,11315000,754973,0.21,-12158,134020,146178,-0.162637907258911,4305.1173944689,209017,0.21
2009-01-23,10561753,11315000,753247,0.18,570,12504,11935,0.344629960185957,4559.07392608324,209587,0.18
2009-01-26,10562356,11315000,752644,0.19,2393,14955,12562,0.382078776159484,4290.80541547762,211980,0.19
2009-01-27,10567625,11315000,747375,0.18,-14008,4782,18790,-0.303305993458391,4588.31400191385,197972,0.18
2009-01-28,10559455,11315000,755545,0.19,-9541,8983,18525,-0.100546060406532,4172.11128036085,188431,0.19
2009-01-29,10567864,11315000,747136,0.23,7734,138439,130704,0.636345152585563,4323.91133440289,196165,0.23
2009-01-30,10569235,11315000,745765,0.23,-27783,18759,46543,-0.832659230363298,4793.29543754475,168382,0.23
2009-02-02,10605283,11315000,709717,0.24,51950,101798,49848,2.28838053573999,3987.20064428388,220332,0.24
2009-02-03,10606098,11315000,708902,0.24,-27172,5409,32581,-0.83010535966727,4096.10495383811,193160,0.24
2009-02-04,10606692,11315000,708308,0.24,-475,10461,10936,0.217738540388221,4202.26735728029,192685,0.24
2009-02-05,10655446,11315000,659554,0.23,40244,128860,88616,1.71806602524738,4710.97935315716,232929,0.23
2009-02-06,10654773,11315000,660227,0.23,-21407,8197,29604,-0.60154989999066,4214.50145378647,211522,0.23
2009-02-09,10655441,11315000,659559,0.22,560,12186,11625,0.221118603276283,4551.46265022017,212082,0.22
2009-02-10,10659121,11315000,655879,0.24,-7577,4059,11636,-0.113046478046777,4666.33153039808,204505,0.24
2009-02-11,10650923,11315000,664077,0.22,-9404,8670,18074,-0.175851248995233,4303.15927979683,195101,0.22
2009-02-12,10696791,11315000,618209,0.23,37372,129062,91690,1.81352828381196,4238.56075041053,232473,0.23
2009-02-13,10696654,11315000,618346,0.22,-32065,10616,42681,-1.05642387623863,4248.06798102721,200408,0.22
2009-02-17,10727599,12104000,1376401,0.25,11653,98049,86395,0.736742807432325,3969.48475245843,212061,0.25
2009-02-18,10727785,12104000,1376215,0.23,-16627,5600,22227,-0.527828424359139,4186.96965416763,195434,0.23
2009-02-19,10739821,12104000,1364179,0.21,8890,109671,100781,0.610090524087937,3984.3083671179,204324,0.21
2009-02-20,10776431,12104000,1327569,0.2,9141,42590,33449,0.616731613239515,3971.64689951718,213465,0.2
2009-02-23,10777331,12104000,1326669,0.19,4830,16057,11227,0.407265711285363,4380.9064252895,218295,0.19
2009-02-24,10781204,12104000,1322796,0.21,-6614,5387,12001,-0.104414552364088,4392.86809905718,211681,0.21
2009-02-25,10775392,12104000,1328608,0.21,-11116,8610,19726,-0.337718458145921,4296.17726829736,200565,0.21
2009-02-26,10818761,12104000,1285239,0.22,33529,145837,112308,1.60773148025628,4081.04333726498,234094,0.22
2009-02-27,10814630,12104000,1289370,0.22,-35139,12475,47614,-1.3549894144744,4523.09563496239,198955,0.22
2009-03-02,10879739,12104000,1224261,0.22,75005,129790,54785,2.91057959617606,4213.42180013739,273960,0.22
2009-03-03,10881457,12104000,1222543,0.2,-27889,5041,32930,-1.1893070867105,4404.22700738049,246071,0.2
2009-03-04,10882000,12104000,1222000,0.21,-2325,10874,13199,-0.0803182176062031,4210.38724456627,243746,0.21
2009-03-05,10890636,12104000,1213364,0.2,-1330,136757,138087,-0.0403781210271657,4579.33402198624,242416,0.2
2009-03-06,10889220,12104000,1214780,0.2,-18510,8728,27238,-0.751645883590103,4385.15678702887,223906,0.2
2009-03-09,10890438,12104000,1213562,0.2,2941,15250,12308,0.131951703923983,4359.61561970632,226847,0.2
2009-03-10,10896227,12104000,1207773,0.2,-7156,4356,11512,-0.330411178076583,4667.21905803813,219691,0.2
2009-03-11,10888961,12104000,1215039,0.19,-9786,8985,18770,-0.430782854356934,3670.50589253619,209905,0.19
2009-03-12,10921180,12104000,1182820,0.18,18560,159683,141123,0.791977837226382,4201.92151925381,228465,0.18
2009-03-13,10921424,12104000,1182576,0.15,-9014,14853,23867,-0.409670611877608,4175.45445601862,219451,0.15
2009-03-16,10970960,12104000,1133040,0.2,71212,102487,31275,2.7347366152848,4122.6398685447,290663,0.2
2009-03-17,10980399,12104000,1123601,0.2,-5826,5525,11351,-0.309495873331889,4344.9028940507,284837,0.2
2009-03-18,10972113,12104000,1131887,0.18,-8280,9484,17765,-0.393642260097095,4149.88841693555,276557,0.18
2009-03-19,10977520,12104000,1126480,0.17,-2490,136896,139385,-0.150790986656224,4413.8612152828,274067,0.17
2009-03-20,10978683,12104000,1125317,0.18,-15496,8408,23904,-0.660592043026264,3749.3685287373,258571,0.18
2009-03-23,10979715,12104000,1124285,0.17,-9160,13037,22197,-0.400041696031256,4572.33929178559,249411,0.17
2009-03-24,10984974,12104000,1119026,0.17,-9327,4277,13604,-0.394285663763293,4450.99036054703,240084,0.17
2009-03-25,10976005,12104000,1127995,0.17,-8500,9436,17936,-0.368155344338254,3867.07628577456,231584,0.17
2009-03-26,10984287,12104000,1119713,0.16,-1738,135468,137206,-0.109538960875283,4419.71827336008,229846,0.16
2009-03-27,10983635,12104000,1120365,0.15,-12042,8084,20126,-0.495832445865744,4441.23336392687,217804,0.15
2009-03-30,10981793,12104000,1122207,0.16,-4130,13947,18077,-0.210720284654444,4330.76303726268,213674,0.16
2009-03-31,11066217,12104000,1037783,0.16,27784,110783,82999,1.13638176814472,4002.0593995219,241458,0.16
2009-04-01,11049972,12104000,1054028,0.16,-29127,22612,51739,-1.23130784288917,4669.47875409243,212331,0.16
2009-04-02,11063784,12104000,1040216,0.16,3893,139616,135723,0.137402006265735,3980.62740079604,216224,0.16
2009-04-03,11085869,12104000,1018131,0.13,-2582,38871,41453,-0.0906002316139611,4258.93878428112,213642,0.13
2009-04-06,11088772,12104000,1015228,0.14,-981,11776,12757,-0.0440287261049095,4464.55715609062,212661,0.14
2009-04-07,11092239,12104000,1011761,0.14,-7046,5789,12835,-0.299909849086648,4260.51825448799,205615,0.14
2009-04-08,11084860,12104000,1019140,0.14,-7359,10206,17565,-0.31380718920808,4178.65097506702,198256,0.14
2009-04-09,11108778,12104000,995222,0.14,17796,157652,139856,0.748542987741042,4092.30154593441,216052,0.14
2009-04-10,11109078,12104000,994922,0.15,-12047,8633,20680,-0.506878384135988,4515.67016454043,204005,0.15
2009-04-13,11109542,12104000,994458,0.13,1649,13807,12158,0.0696943515353151,4769.72478391424,205654,0.13
2009-04-14,11112704,12104000,991296,0.16,6255,16933,10678,0.288130632161189,4486.97137718557,211909,0.16
2009-04-15,11160575,12104000,943425,0.16,57104,99855,42750,2.36748464056848,3547.33488245104,269013,0.16
2009-04-16,11125587,12104000,978413,0.15,-39030,95260,134290,-1.6402358814516,4549.13465162018,229983,0.15
2009-04-17,11127443,12104000,976557,0.13,-2426,19492,21918,-0.115037090986232,4568.75712076834,227557,0.13
2009-04-20,11131229,12104000,972771,0.14,10358,22522,12164,0.407859166941845,4699.60958147099,237915,0.14
2009-04-21,11135346,12104000,968654,0.15,25144,39038,13894,0.974903776912912,4776.66880337572,263059,0.15
2009-04-22,11132984,12104000,971016,0.15,5036,23452,18416,0.137219561031884,3920.37508004706,268095,0.15
2009-04-23,11126833,12104000,977167,0.17,-6531,100049,106581,-0.302338722094283,3924.54664614625,261564,0.17
2009-04-24,11127249,12104000,976751,0.16,-4232,20078,24310,-0.245598293582404,3644.56308178948,257332,0.16
2009-04-27,11131521,12104000,972479,0.17,14263,22830,8567,0.715955667168408,4548.17684762824,271595,0.17
2009-04-28,11136443,12104000,967557,0.16,1118,13371,12253,0.0231904839801887,4750.70686160708,272713,0.16
2009-04-29,11095065,12104000,1008935,0.18,-35332,11605,46937,-1.73262278446531,4471.62712333651,237381,0.18
2009-04-30,11178827,12104000,925173,0.2,73382,204681,131300,3.06406568699234,4236.72836819556,310763,0.2
2009-05-01,11148348,12104000,955652,0.22,-54302,22801,77103,-2.22013481058998,4306.52096346113,256461,0.22
2009-05-04,11160351,12104000,943649,0.22,407,15805,15398,-0.0138389080535925,4468.45122701971,256868,0.22
2009-05-05,11167882,12104000,936118,0.2,-7983,6673,14656,-0.3508969193932,4411.95379775129,248885,0.2
2009-05-06,11167262,12104000,936738,0.18,-3649,11852,15501,-0.182882090993311,3922.21161484019,245236,0.18
2009-05-07,11196543,12104000,907457,0.18,14161,157694,143533,0.541755450330214,4065.61594964404,259397,0.18
2009-05-08,11199006,12104000,904994,0.17,-4414,7264,11678,-0.214879713083846,4690.14176546495,254983,0.17
2009-05-11,11200876,12104000,903124,0.17,42,10774,10732,0.0426340610521556,4722.85642070928,255025,0.17
2009-05-12,11204257,12104000,899743,0.16,-11764,3673,15437,-0.488878471909329,4728.42166248464,243261,0.16
2009-05-13,11195985,12104000,908015,0.16,-11533,8352,19884,-0.473916746646728,4450.53618349912,231728,0.16
2009-05-14,11210533,12104000,893467,0.16,5363,139143,133780,0.285879150582746,4420.23374624336,237091,0.16
2009-05-15,11223976,12104000,880024,0.17,-12761,134582,147343,-0.542344242334458,4390.68805216547,224330,0.17
2009-05-18,11226564,12104000,877436,0.16,2842,17789,14947,0.155041582720934,4270.39680203437,227172,0.16
2009-05-19,11233361,12104000,870639,0.15,-6394,3348,9742,-0.27003150619124,4535.14620850747,220778,0.15
2009-05-20,11225503,12104000,878497,0.14,-8282,10701,18983,-0.356557537510592,4041.03143088455,212496,0.14
2009-05-21,11245678,12104000,858322,0.17,-688,135291,135980,-0.0108299407241494,4153.67804911674,211808,0.17
2009-05-22,11241715,12104000,862285,0.17,-9785,7471,17255,-0.429560875312238,4553.28545842154,202023,0.17
2009-05-26,11245772,12104000,858228,0.18,1104,11441,10337,0.0625841713349074,4207.22882771191,203127,0.18
2009-05-27,11241327,12104000,862673,0.17,-17769,5584,23353,-0.759856420138921,3678.39169436085,185358,0.17
2009-05-28,11251853,12104000,852147,0.17,9021,141758,132737,0.448372878092661,4536.82152520763,194379,0.17
2009-05-29,11260445,12104000,843555,0.19,-4604,11856,16460,-0.186699367415132,4692.00888331545,189775,0.19
2009-06-01,11318845,12104000,785155,0.21,49572,128434,78862,2.1690829810755,4399.4152038327,239347,0.21
2009-06-02,11321651,12104000,782349,0.2,-4829,6323,11152,-0.238135864481214,4461.0653075887,234518,0.2
2009-06-03,11313214,12104000,790786,0.21,-22318,9962,32280,-0.98468462153885,3909.72731511693,212200,0.21
2009-06-04,11327794,12104000,776206,0.2,292,194196,193904,-0.00280266962930392,4338.49672112431,212492,0.2
2009-06-05,11326772,12104000,777228,0.21,-3885,6646,10531,-0.163438909266448,4145.03418217855,208607,0.21
2009-06-08,11329178,12104000,774822,0.21,733,11215,10482,0.0265910634643994,4326.67871705711,209340,0.21
2009-06-09,11330416,12104000,773584,0.18,-6850,3924,10774,-0.299925824602906,4487.04265317688,202490,0.18
2009-06-10,11322976,12104000,781024,0.18,-10768,9403,20170,-0.453864298762702,4368.30634963778,191722,0.18
2009-06-11,11314565,12104000,789435,0.17,-7016,130916,137932,-0.238169412548915,4360.71388241486,184706,0.17
2009-06-12,11313923,12104000,790077,0.17,-2872,14153,17025,-0.0845921110695338,4489.62743204505,181834,0.17
2009-06-15,11339790,12104000,764210,0.22,54516,113296,58780,2.51407744642779,4088.640195713,236350,0.22
2009-06-16,11345111,12104000,758889,0.22,6982,16723,9741,0.317518008468165,4271.48294088666,243332,0.22
2009-06-17,11341900,12104000,762100,0.24,64031,80170,16139,2.67666777444763,3339.84205025251,307363,0.24
2009-06-18,11338362,12104000,765638,0.25,-10649,98506,109155,-0.482125068907985,5123.24868195395,296714,0.25
2009-06-19,11336847,12104000,767153,0.25,1920,13915,11995,0.042188989738527,4163.41900813521,298634,0.25
2009-06-22,11339887,12104000,764113,0.24,7557,17569,10012,0.269019551812928,4422.56204663645,306191,0.24
2009-06-23,11347236,12104000,756764,0.24,-5820,6377,12198,-0.278518489699809,4504.19737181728,300371,0.24
2009-06-24,11304947,12104000,799053,0.21,-46934,9164,56098,-1.88385518947038,3848.28197288831,253437,0.21
2009-06-25,11302769,12104000,801231,0.19,-9242,96922,106164,-0.391364555557257,4691.80663514464,244195,0.19
2009-06-26,11301765,12104000,802235,0.18,-10522,8005,18526,-0.410022630129267,3693.07110638631,233673,0.18
2009-06-29,11297777,12104000,806223,0.17,3336,16433,13096,0.199350009984315,4031.18587646798,237009,0.17
2009-06-30,11487470,12104000,616530,0.22,53485,120464,66979,2.50830039208359,3982.5298192369,290494,0.22
2009-07-01,11460698,12104000,643302,0.2,-37766,20669,58436,-1.73513045741167,4423.26072023867,252728,0.2
2009-07-02,11431591,12104000,672409,0.17,-52902,136443,189345,-2.21489201857203,4345.58340175255,199826,0.17
2009-07-02,11431591,12104000,672409,0.17,-52902,136443,189345,-2.21489201857203,4345.58340175255,199826,0.17
2009-07-06,11462565,12104000,641435,0.18,30125,39596,9471,1.29816563002897,3892.04172843419,229951,0.18
2009-07-07,11465866,12104000,638134,0.18,-10582,3491,14074,-0.406916040922429,4759.45232835386,219369,0.18
2009-07-08,11457117,12104000,646883,0.16,-8099,8655,16754,-0.293790849876296,3818.45808031345,211270,0.16
2009-07-09,11468321,12104000,635679,0.15,-13104,104632,117736,-0.50194927761729,4323.87641520526,198166,0.15
2009-07-10,11466652,12104000,637348,0.15,-4077,7828,11905,-0.13173300738464,3677.1727816181,194089,0.15
2009-07-13,11467526,12104000,636474,0.13,-255,11111,11366,0.0347466114732861,4558.30038884238,193834,0.13
2009-07-14,11471153,12104000,632847,0.13,-2428,8390,10818,-0.0676880934404733,4224.9993905325,191406,0.13
2009-07-15,11521620,12104000,582380,0.14,48060,88619,40558,1.91502950133205,3910.71240861012,239466,0.14
2009-07-16,11540565,12104000,563435,0.15,14463,147509,133046,0.545151822936551,4758.78895250088,253929,0.15
2009-07-17,11542665,12104000,561335,0.15,-3950,6166,10116,-0.195648473560552,4515.36594625191,249979,0.15
2009-07-20,11543535,12104000,560465,0.15,-406,10280,10686,-0.0540516462926234,4526.88684181209,249573,0.15
2009-07-21,11546658,12104000,557342,0.14,-6250,3442,9693,-0.291933803743066,4819.16868242673,243323,0.14
2009-07-22,11537819,12104000,566181,0.14,-7377,10850,18227,-0.328146853201221,3929.74913775858,235946,0.14
2009-07-23,11547797,12104000,556203,0.15,5142,136856,131714,0.151122684540673,4272.68238588301,241088,0.15
2009-07-24,11548834,12104000,555166,0.15,-5528,6794,12322,-0.264438127390946,3966.35589849071,235560,0.15
2009-07-27,11550181,12104000,553819,0.16,3127,12108,8982,0.0768347860039108,4419.33253767709,238687,0.16
2009-07-28,11555130,12104000,548870,0.15,-7217,3806,11024,-0.29824933547651,4197.36168409906,231470,0.15
2009-07-29,11553669,12104000,550331,0.17,721,11306,10586,0.033119803653486,3610.05197517876,232191,0.17
2009-07-30,11523482,12104000,580518,0.17,-32232,162295,194527,-1.34047552108765,4792.41886501772,199959,0.17
2009-07-31,11611153,12104000,492847,0.18,67355,129287,61932,2.52716122812992,4079.34819285771,267314,0.18
2009-08-03,11590120,12104000,513880,0.18,-24593,24409,49002,-0.963112484341497,4323.67610199014,242721,0.18
2009-08-04,11601243,12104000,502757,0.17,-7094,5505,12599,-0.293046639565037,4342.84523031209,235627,0.17
2009-08-05,11600704,12104000,503296,0.17,284,10978,10694,-0.0208733630289158,3657.81739370821,235911,0.17
2009-08-06,11601723,12104000,502277,0.17,-6341,136061,142402,-0.276220497050031,3894.70361109212,229570,0.17
2009-08-07,11599820,12104000,504180,0.17,-4062,7522,11584,-0.192771408528741,4407.55794675104,225508,0.17
2009-08-10,11603637,12104000,500363,0.17,-845,11235,12081,-0.0726827222522623,4238.42856324302,224663,0.17
2009-08-11,11608203,12104000,495797,0.16,-7585,3786,11371,-0.285060273572297,4156.94892490703,217078,0.16
2009-08-12,11599937,12104000,504063,0.15,-6977,9962,16939,-0.246749394927983,4041.58091759797,210101,0.15
2009-08-13,11604525,12104000,499475,0.15,-8179,143569,151748,-0.245298961862544,4979.73900914559,201922,0.15
2009-08-14,11611505,12104000,492495,0.15,-2533,10093,12627,-0.00442719600287199,4556.84862039616,199389,0.15
2009-08-17,11624348,12104000,479652,0.17,-6913,107975,114889,-0.188796434082587,4468.2481617431,192476,0.17
2009-08-18,11668291,12104000,435709,0.17,29051,39309,10258,1.35165366699513,4520.61363688253,221527,0.17
2009-08-19,11659956,12104000,444044,0.17,-6876,10017,16893,-0.205213203464492,4148.49085545307,214651,0.17
2009-08-20,11662513,12104000,441487,0.17,-4801,129489,134290,-0.169479081733382,4228.24909041969,209850,0.17
2009-08-21,11660970,12104000,443030,0.16,-6609,7048,13657,-0.255295016115,4604.73216936526,203241,0.16
2009-08-24,11660855,12104000,443145,0.16,-1544,12315,13858,-0.0341195242338949,4357.84281497165,201697,0.16
2009-08-25,11672026,12104000,431974,0.15,-5791,3225,9015,-0.218238950506202,4449.52530337752,195906,0.15
2009-08-26,11658216,12104000,445784,0.15,-8743,9620,18363,-0.308274891557756,3882.36941756506,187163,0.15
2009-08-27,11666978,12104000,437022,0.14,-1506,128104,129609,0.00891803830903424,4320.1535826609,185657,0.14
2009-08-28,11660285,12104000,443715,0.14,-2515,8635,11150,-0.121567445886905,4145.55927947998,183142,0.14
2009-08-31,11755205,12104000,348795,0.15,84507,124796,40289,3.90933321772779,4602.60336778123,267649,0.15
2009-09-01,11735280,12104000,368720,0.15,-34043,13646,47689,-1.56270889838032,5039.97070498856,233606,0.15
2009-09-02,11739932,12104000,364068,0.16,-519,11262,11781,-0.0484483528898648,4260.61487476997,233087,0.16
2009-09-03,11729501,12104000,374499,0.15,-34324,93290,127614,-1.52233801796553,4313.65113819645,198763,0.15
2009-09-04,11727709,12104000,376291,0.15,-6065,9369,15435,-0.267200841367917,4588.86480826919,192698,0.15
2009-09-08,11730205,12104000,373795,0.15,-3316,12133,15449,-0.14196363390669,4573.84763550964,189382,0.15
2009-09-09,11727236,12104000,376764,0.15,-12232,6911,19143,-0.524240174705277,4413.72417732373,177150,0.15
2009-09-10,11737743,12104000,366257,0.16,6413,122699,116285,0.366926613424636,3778.84737612721,183563,0.16
2009-09-11,11737418,12104000,366582,0.15,-3749,9396,13145,-0.089724484798243,4386.19127725125,179814,0.15
2009-09-14,11735417,12104000,368583,0.16,2957,17953,14996,0.219321503045914,4333.77489279595,182771,0.16
2009-09-15,11777018,12104000,326982,0.17,62388,111836,49449,2.66560927076793,4515.66812648709,245159,0.17
2009-09-16,11770820,12104000,333180,0.17,1633,19017,17384,0.0660057441692917,4240.59472206734,246792,0.17
2009-09-17,11752077,12104000,351923,0.16,-22176,82670,104846,-0.925191669799157,4240.63663113236,224616,0.16
2009-09-18,11750531,12104000,353469,0.16,1581,16387,14806,0.0825954678751679,4567.76613702362,226197,0.16
2009-09-21,11754027,12104000,349973,0.15,4771,19348,14577,0.206612308277838,4280.20949003334,230968,0.15
2009-09-22,11762596,12104000,341404,0.15,2943,13585,10642,0.129507216987846,4876.76605853536,233911,0.15
2009-09-23,11756716,12104000,347284,0.15,-8667,12393,21059,-0.359753685403599,3717.57193117928,225244,0.15
2009-09-24,11713551,12104000,390449,0.14,-53519,111728,165247,-2.07062428069769,3967.38657682863,171725,0.14
2009-09-25,11713594,12104000,390406,0.13,-6713,6952,13665,-0.237024780785472,3515.94271853226,165012,0.13
2009-09-28,11714419,12104000,389581,0.13,-702,12974,13676,0.0850883897286937,4433.19095251136,164310,0.13
2009-09-29,11719105,12104000,384895,0.11,-2547,8089,10636,-0.0240790094248739,4385.85917267526,161763,0.11
2009-09-30,11853434,12104000,250566,0.07,85936,138376,52440,3.32317100299994,3908.46389709828,247699,0.07
2009-10-01,11864112,12104000,239888,0.11,-77558,99226,176785,-2.65818454587935,4875.66963313026,170141,0.11
2009-10-02,11861565,12104000,242435,0.13,-24337,9027,33364,-0.772983821325229,4032.166803365,145804,0.13
2009-10-05,11863589,12104000,240411,0.13,-2379,10422,12801,-0.0113619814304673,4438.9546541307,143425,0.13
2009-10-06,11872067,12104000,231933,0.12,-8273,4070,12343,-0.209632375230508,4168.11248781881,135152,0.12
2009-10-07,11870374,12104000,233626,0.13,237,11275,11037,0.0791978440773665,4153.37777961008,135389,0.13
2009-10-08,11843602,12104000,260398,0.12,-35175,94265,129439,-1.10885397881206,4317.08655468418,100214,0.12
2009-10-09,11840471,12104000,263529,0.12,-2989,6551,9540,-0.0127115702616574,4503.58158659781,97225,0.12
2009-10-13,11852373,12104000,251627,0.12,6516,21182,14666,0.304343739911535,4081.8816135629,103741,0.12
2009-10-14,11848377,12104000,255623,0.12,-13769,7526,21296,-0.38228694743337,4605.92679435102,89972,0.12
2009-10-15,11891485,12104000,212515,0.13,38894,184860,145966,1.39102830722674,3951.3298376261,128866,0.13
2009-10-16,11893527,12104000,210473,0.12,-3018,13199,16217,-0.026941455237633,4599.30821808244,125848,0.12
2009-10-19,11897484,12104000,206516,0.12,-2911,11122,14033,-0.0249263181218061,4589.06550598855,122937,0.12
2009-10-20,11901481,12104000,202519,0.12,-5957,5791,11748,-0.128342583710144,4272.83772217013,116980,0.12
2009-10-21,11893375,12104000,210625,0.11,-3842,13351,17193,-0.0549767610989878,4138.1301117085,113138,0.11
2009-10-22,11841614,12104000,262386,0.11,-61638,121569,183208,-1.86784283819762,4623.40230010016,51500,0.11
2009-10-23,11840716,12104000,263284,0.11,-1062,8324,9386,0.0758621688264568,4150.75256515525,50438,0.11
2009-10-26,11842476,12104000,261524,0.11,545,10338,9792,0.125933183568883,4186.25403970192,50983,0.11
2009-10-27,11846339,12104000,257661,0.11,-6377,5105,11483,-0.0937868556348771,4379.23532427715,44606,0.11
2009-10-28,11838600,12104000,265400,0.11,-9607,9385,18992,-0.137327323519797,4205.10707864344,34999,0.11
2009-10-29,11813373,12104000,290627,0.11,-26878,112276,139154,-0.774122570220134,3964.80017591311,8121,0.11
2009-10-30,11836919,12104000,267081,0.11,1030,42841,41811,0.241496874370578,3848.1997599991,9151,0.11
2009-11-02,11918903,12104000,185097,0.12,87488,143973,56484,2.92925772618282,4563.30970001533,96639,0.12
2009-11-03,11922192,12104000,181808,0.12,-27229,7357,34585,-0.779388538824288,4861.86331711266,69410,0.12
2009-11-04,11921988,12104000,182012,0.13,1612,12202,10591,0.147496496534124,3854.88552966562,71022,0.13
2009-11-05,11933585,12104000,170415,0.13,996,101585,100589,0.117065315539487,4394.21426342152,72018,0.13
2009-11-06,11931923,12104000,172077,0.12,-4093,7128,11221,-0.0388691982115066,4085.36124648552,67925,0.12
2009-11-09,11933128,12104000,170872,0.12,-28,9942,9969,0.0895590847596759,4905.10199172314,67897,0.12
2009-11-10,11930078,12104000,173922,0.13,-15484,4539,20023,-0.39463799170611,4777.03700820684,52413,0.13
2009-11-12,11934355,12104000,169645,0.12,977,103821,102844,0.198281585924443,4655.69373685905,53390,0.12
2009-11-13,11934662,12104000,169338,0.12,-12220,10326,22547,-0.243194932867153,4357.47585109283,41170,0.12
2009-11-16,11974516,12104000,129484,0.12,27057,114588,87531,1.05290655444023,4407.1148968782,68227,0.12
2009-11-17,11982556,12104000,121444,0.12,-7867,4631,12497,-0.126552469802771,4444.85058821861,60360,0.12
2009-11-18,11973460,12104000,130540,0.11,-8627,10222,18850,-0.141142118282752,3922.13587209907,51733,0.11
2009-11-19,11954947,12104000,149053,0.11,-29418,129184,158603,-0.814849043900788,4547.86601998281,22315,0.11
2009-11-20,11953740,12104000,150260,0.11,-4371,6907,11277,0.0274102226971454,4186.67469099929,17944,0.11
2009-11-23,11955075,12104000,148925,0.12,521,11598,11078,0.152409636785402,4420.30832150234,18465,0.12
2009-11-24,11959576,12104000,144424,0.12,-7742,5307,13049,-0.136016623606172,4642.46808914506,10723,0.12
2009-11-25,11952728,12104000,151272,0.11,-8298,10584,18882,-0.148815324268114,4678.72296670858,2425,0.11
2009-11-27,11951936,12104000,152064,0.12,-1821,107788,109608,0.0772938789758709,4235.97234541387,604,0.12
2009-11-30,12057363,12104000,46637,0.13,88027,134519,46493,3.20166152668009,4076.7242268062,88631,0.13
2009-12-01,12033560,12104000,70440,0.13,-37647,14243,51890,-1.29651859833949,4956.20880927258,50984,0.13
2009-12-02,12035178,12104000,68822,0.13,-1411,11347,12758,0.037518041836492,4212.91488240021,49573,0.13
2009-12-03,12031703,12104000,72297,0.13,-27183,101903,129086,-0.90130389657923,5038.78223659028,22390,0.13
2009-12-04,12031804,12104000,72196,0.12,-2741,8556,11297,0.00547147867843909,4043.92090056173,19649,0.12
2009-12-07,12030588,12104000,73412,0.12,-4817,10410,15227,-0.0673147790263297,4481.26392318131,14832,0.12
2009-12-08,12035728,12104000,68272,0.12,-7318,3897,11215,-0.190237470959384,4109.26905435883,7514,0.12
2009-12-09,12024193,12104000,79807,0.12,37270,55544,18273,1.42788480458714,3736.2093117796,44784,0.12
2009-12-10,12037115,12104000,66885,0.12,4894,123906,119012,0.231241612978558,4761.04631424115,49678,0.12
2009-12-11,12026170,12104000,77830,0.12,-3798,8988,12786,-0.100073333894308,4071.96180508407,45880,0.12
2009-12-14,12015797,12104000,88203,0.12,-13554,16732,30286,-0.425095576408918,4592.2367645394,32326,0.12
2009-12-15,12079506,12104000,24494,0.13,89407,119459,30051,2.98780899717401,4551.85001008224,121733,0.13
2009-12-16,12073627,12104000,30373,0.14,-261,18600,18861,-0.00749042061683103,4293.72396135909,121472,0.14
2009-12-17,12042131,12104000,61869,0.13,-42853,127224,170078,-1.36459385764926,4077.55115234622,78619,0.13
2009-12-18,12042433,12104000,61567,0.12,1281,11941,10660,0.0687953065375987,3978.53598342764,79900,0.12
2009-12-21,12043745,12104000,60255,0.12,3434,14343,10909,0.0907349544534907,4495.3519709648,83334,0.12
2009-12-22,12039592,12104000,64408,0.12,-3291,8331,11622,-0.138616512494852,3802.48909080806,80043,0.12
2009-12-23,12047140,12104000,56860,0.11,28821,57681,28860,0.930518505590235,4204.79258835809,108864,0.11
2009-12-24,12045805,12104000,58195,0.11,-7385,102639,110024,-0.29929446613041,4353.07453908811,101479,0.11
2009-12-28,12049042,12394000,344958,0.12,3129,14837,11709,0.0472826887186837,4194.97753971701,104608,0.12
2009-12-29,12044837,12394000,349163,0.12,-13927,12570,26497,-0.549170233747033,4527.65972582494,90681,0.12
2009-12-30,12089528,12394000,304472,0.11,38288,64940,26652,1.18929682112781,4177.8980622143,128969,0.11
2009-12-31,12254530,12394000,139470,0.05,37060,223439,186379,1.31132618429294,4052.98195767096,166029,0.05
2010-01-04,12233486,12394000,160514,0.12,-14767,29540,44307,-0.630521882054741,4591.50545797725,151262,0.12
2010-01-05,12246566,12394000,147434,0.12,-8464,6405,14869,-0.383958971857402,4537.07507486053,142798,0.12
2010-01-06,12245363,12394000,148637,0.12,3173,14323,11150,0.0495611810577284,4427.67756843246,145971,0.12
2010-01-07,12224116,12394000,169884,0.1,-28466,74360,102826,-1.09486361778618,4471.04601473447,117505,0.1
2010-01-08,12223892,12394000,170108,0.11,1684,13254,11571,0.0148059473612263,4416.10988152631,119189,0.11
2010-01-11,13668174,14294000,625826,0.11,-268,12357,12626,-0.0715174207430115,4707.3197478746,118921,0.11
2010-01-12,12234523,12394000,159477,0.11,-6008,7155,13163,-0.277392550780361,4283.10929301051,112913,0.11
2010-01-13,12225646,12394000,168354,0.11,-9306,10102,19408,-0.402637509157374,4185.71900292274,103607,0.11
2010-01-14,12201827,12394000,192173,0.11,-30989,98954,129942,-1.14572164183542,4816.38926627466,72618,0.11
2010-01-15,12262625,12394000,131375,0.12,53052,104400,51348,1.8127159093387,4345.34247211885,125670,0.12
2010-01-19,12265473,12394000,128527,0.13,12054,23162,11109,0.349200929939592,4555.66354679396,137724,0.13
2010-01-20,12270763,12394000,123237,0.13,12210,32658,20448,0.322875065275728,3688.77223433833,149934,0.13
2010-01-21,12243553,12394000,150447,0.12,-30473,74526,104998,-1.16166514234571,4356.00400505595,119461,0.12
2010-01-22,12245872,12394000,148128,0.11,-4573,8555,13128,-0.245575574265363,3614.93134712742,114888,0.11
2010-01-25,12247193,12394000,146807,0.12,2630,13749,11118,-0.00140454979746663,4287.32486791191,117518,0.12
2010-01-26,12252359,12394000,141641,0.12,-4333,7092,11425,-0.250445151200357,4797.48578887363,113185,0.12
2010-01-27,12245262,12394000,148738,0.12,-7042,10734,17777,-0.34096779645605,4640.02961778998,106143,0.12
2010-01-28,12217917,12394000,176083,0.12,-32162,69722,101883,-1.25595652791613,4220.50035963916,73981,0.12
2010-01-29,12222507,12394000,171493,0.12,-10036,13134,23170,-0.42044171839368,4512.19502728835,63945,0.12
2010-02-01,12292948,12394000,101052,0.14,65362,146672,81310,2.37368360117722,4516.29701342727,129307,0.14
2010-02-02,12304445,12394000,89555,0.14,-4196,6571,10767,-0.257220618100906,4604.44081571224,125111,0.14
2010-02-03,12297559,12394000,96441,0.13,-23143,11127,34271,-0.947464491213461,4388.08723560751,101968,0.13
2010-02-04,12289934,12394000,104066,0.14,-17768,78192,95960,-0.728714140654258,4552.10073421541,84200,0.14
2010-02-05,12289033,12394000,104967,0.13,-26193,7967,34160,-1.01346411768624,4316.01377228337,58007,0.13
2010-02-08,12291474,12394000,102526,0.13,614,13844,13231,0.0101337033642859,4185.92227762123,58621,0.13
2010-02-09,12293055,12394000,100945,0.13,-8278,5343,13621,-0.313268221633051,4508.18590578418,50343,0.13
2010-02-10,12284174,12394000,109826,0.12,-2829,16953,19783,-0.108400236943439,4340.84268563473,47514,0.12
2010-02-11,12292830,12394000,101170,0.12,223,111491,111268,-0.00615082698512184,4393.6699495293,47737,0.12
2010-02-12,12295146,14294000,1998854,0.12,-32098,11525,43623,-1.30332188133717,4176.45702206342,15639,0.12
2010-02-16,12327944,14294000,1966056,0.13,26093,126047,99954,1.21881767121042,4633.85865915393,41732,0.13
2010-02-17,12330098,14294000,1963902,0.12,-12673,8720,21393,-0.516239877825197,4137.82297564526,29059,0.12
2010-02-18,12345033,14294000,1948967,0.12,11005,97534,86529,0.539846670722908,4090.51635425706,40064,0.12
2010-02-19,12345655,14294000,1948345,0.13,-27094,7715,34809,-1.12124860040954,3997.91845393146,12970,0.13
2010-02-22,12346676,14294000,1947324,0.12,-961,13898,14859,0.0327451153691175,4760.13258385447,12009,0.12
2010-02-23,12353040,14294000,1940960,0.12,-9285,5488,14773,-0.300453955105193,4168.40747254186,2724,0.12
2010-02-24,12345462,14294000,1948538,0.11,-10375,9810,20185,-0.346115017224385,4263.94624582693,-7651,0.11
2010-02-25,12377320,14294000,1916680,0.12,28038,121113,93075,1.33334316957499,4506.41369068435,20387,0.12
2010-02-26,12383717,14294000,1910283,0.13,-6163,19345,25508,-0.188652033130997,4536.2879440255,14224,0.13
2010-03-01,12451202,14294000,1842798,0.14,64899,150694,85795,2.74543773622515,4497.25227742734,79123,0.14
2010-03-02,12463105,14294000,1830895,0.14,-5886,6734,12620,-0.153152337044558,4455.14722611377,73237,0.14
2010-03-03,12452642,14294000,1841358,0.15,-20517,13809,34326,-0.772119665534912,3904.41236468333,52720,0.15
2010-03-04,12489163,14294000,1804837,0.16,24718,116744,92026,1.10960149125032,4094.04004320876,77438,0.16
2010-03-05,12488396,14294000,1805604,0.17,-17473,8610,26083,-0.642037267925895,4111.59105369894,59965,0.17
2010-03-08,12490111,14294000,1803889,0.15,2982,17896,14914,0.184997788625499,4386.90870406232,62947,0.15
2010-03-09,12496458,14294000,1797542,0.14,-6682,6626,13308,-0.217387880163763,4113.16051925315,56265,0.14
2010-03-10,12488161,14294000,1805839,0.14,-8585,11317,19902,-0.289207849119247,4668.59167065418,47680,0.14
2010-03-11,12519121,14294000,1774879,0.15,22422,148275,125852,0.986123635832108,4131.61448775135,70102,0.15
2010-03-12,12519337,14294000,1774663,0.17,-6893,13346,20238,-0.247140162461058,4877.17643227998,63209,0.17
2010-03-15,12580370,14294000,1713630,0.2,86808,115663,28856,3.1360156227198,4629.76814565694,150017,0.2
2010-03-16,12587425,14294000,1706575,0.2,4685,15258,10573,0.153628951305555,4274.76507031079,154702,0.2
2010-03-17,12583519,14294000,1710481,0.18,-7829,11459,19288,-0.313057346008355,4231.01464237224,146873,0.18
2010-03-18,12604994,14294000,1689006,0.18,13214,119606,106391,0.503282658444827,4380.12711084312,160087,0.18
2010-03-19,12604757,14294000,1689243,0.18,-16731,9334,26065,-0.68167240218908,3985.33302267041,143356,0.18
2010-03-22,12607140,14294000,1686860,0.18,353,14339,13987,-0.0144657161831906,4487.94374345807,143709,0.18
2010-03-23,12614680,14294000,1679320,0.17,-8148,3876,12024,-0.337974364431681,4751.77805810541,135561,0.17
2010-03-24,12606268,14294000,1687732,0.17,-11062,9398,20459,-0.444937788564948,4065.7892503881,124499,0.17
2010-03-25,12631334,14294000,1662666,0.17,17671,124495,106824,0.654714612037767,4620.66331277231,142170,0.17
2010-03-26,12629674,14294000,1664326,0.17,-16664,7271,23935,-0.711937125931604,4030.22060239489,125506,0.17
2010-03-29,12630081,14294000,1663919,0.16,-3631,13847,17478,-0.201858635603118,4572.9480105445,121875,0.16
2010-03-30,12628419,14294000,1665581,0.16,-6483,6172,12655,-0.267324225711438,4975.72062157516,115392,0.16
2010-03-31,12716511,14294000,1577489,0.09,75546,141081,65535,2.85514277158733,4528.68441915022,190938,0.09
2010-04-01,12708227,14294000,1585773,0.17,-24330,151503,175833,-1.00127175794001,4224.04007344432,166608,0.17
2010-04-02,12706109,14294000,1587891,0.2,-34502,8895,43398,-1.35404702771432,4378.23601972809,132106,0.2
2010-04-05,12729973,14294000,1564027,0.2,20488,34216,13728,0.692948211937277,4371.38954797656,152594,0.2
2010-04-06,12736395,14294000,1557605,0.2,-8515,5831,14346,-0.406398409174468,4330.84831970065,144079,0.2
2010-04-07,12735322,14294000,1558678,0.19,779,12630,11851,-0.0605545483601664,3985.30240582481,144858,0.19
2010-04-08,12769306,14294000,1524694,0.19,24010,153087,129077,0.795666376885219,4147.56769446368,168868,0.19
2010-04-09,12768979,14294000,1525021,0.19,-10480,8692,19172,-0.500871742851934,4626.22111644633,158388,0.19
2010-04-12,12769723,14294000,1524277,0.19,4486,13999,9513,0.0311637031855434,4427.80700556962,162874,0.19
2010-04-13,12774554,14294000,1519446,0.2,-1297,9998,11295,-0.167779590464458,4625.78613164447,161577,0.2
2010-04-14,12766870,14294000,1527130,0.2,-2726,17055,19781,-0.234334577048533,4364.49400947351,158851,0.2
2010-04-15,12817961,14294000,1476039,0.22,61172,234026,172854,2.09454761509466,4533.94354121449,220023,0.22
2010-04-16,12821074,14294000,1472926,0.21,-4613,15464,20077,-0.363490216510085,4449.31311436749,215410,0.21
2010-04-19,12806461,14294000,1487539,0.2,-7037,23759,30795,-0.447977592424166,4207.43373307934,208373,0.2
2010-04-20,12814685,14294000,1479315,0.2,23977,36481,12504,0.682209663606902,4304.91198147581,232350,0.2
2010-04-21,12808961,14294000,1485039,0.2,4123,25199,21076,-0.0744253707089827,3880.11274954818,236473,0.2
2010-04-22,12816020,14294000,1477980,0.2,-8247,118740,126987,-0.508120443458627,3989.59223480295,228226,0.2
2010-04-23,12820632,14294000,1473368,0.2,-1760,20207,21967,-0.267481829633347,3804.9706399176,226466,0.2
2010-04-26,12823852,14294000,1470148,0.2,12168,20896,8728,0.332238654554233,4375.15374423737,238634,0.2
2010-04-27,12829821,14294000,1464179,0.2,4390,15324,10933,0.00591487222452358,4289.95793842924,243024,0.2
2010-04-28,12820257,14294000,1473743,0.2,-11735,10323,22057,-0.664420123796617,3910.78070028406,231289,0.2
2010-04-29,12796593,14294000,1497407,0.19,-24929,99013,123942,-1.14502866025705,4532.50540899177,206360,0.19
2010-04-30,12892729,14294000,1401271,0.2,66307,147468,81161,2.32007079345648,3404.42968057794,272667,0.2
2010-05-03,12870424,14294000,1423576,0.2,-24539,28927,53466,-1.09215742468306,4615.13973261778,248128,0.2
2010-05-04,12884375,14294000,1409625,0.21,-7490,9032,16522,-0.452881216067958,4355.77543695068,240638,0.21
2010-05-05,12886933,14294000,1407067,0.21,3697,16505,12808,-0.0457873828599891,3543.98756133831,244335,0.21
2010-05-06,12876208,14294000,1417792,0.2,-22065,134646,156711,-0.964917098265309,4343.42787703628,222270,0.2
2010-05-07,12872254,14294000,1421746,0.2,-8814,7986,16800,-0.468492197533767,4051.76160032559,213456,0.2
2010-05-10,12870150,14294000,1423850,0.2,-6513,12397,18909,-0.341464003745132,4656.03768700997,206943,0.2
2010-05-11,12874540,14294000,1419460,0.2,-6481,5167,11648,-0.327697637475346,4560.18335784241,200462,0.2
2010-05-12,12866561,14294000,1427439,0.2,-9793,11067,20860,-0.467494832641427,4388.77702050518,190669,0.2
2010-05-13,12870777,14294000,1423223,0.2,-4124,117039,121163,-0.206093646874425,4204.49865610709,186545,0.2
2010-05-14,12870073,14294000,1423927,0.2,-4980,13577,18558,-0.257293308324549,4511.53676585734,181565,0.2
2010-05-17,12918332,14294000,1375668,0.21,38407,112309,73902,1.53266157705031,4294.94537716804,219972,0.21
2010-05-18,12928120,14294000,1365880,0.21,-7427,4196,11623,-0.392800177092261,4516.5221888683,212545,0.21
2010-05-19,12918763,14294000,1375237,0.2,-7951,11178,19129,-0.418753366798563,4196.52839091007,204594,0.2
2010-05-20,12931259,14294000,1362741,0.2,2527,119263,116736,0.038218302221376,4239.63011292783,207121,0.2
2010-05-21,12931251,14294000,1362749,0.2,-6383,7183,13566,-0.351879259569891,4199.85584437038,200738,0.2
2010-05-24,12932602,14294000,1361398,0.21,2806,12600,9795,0.0325665875505037,3941.85043767719,203544,0.21
2010-05-25,12939304,14294000,1354696,0.21,-4360,4633,8993,-0.275249874888371,4457.18081907928,199184,0.21
2010-05-26,12930816,14294000,1363184,0.2,-8055,11965,20019,-0.398160037847258,4371.42725548533,191129,0.2
2010-05-27,12931427,14294000,1362573,0.2,6979,118706,111727,0.311451087184784,4428.33465921087,198108,0.2
2010-05-28,12937208,14294000,1356792,0.19,-3811,11838,15648,-0.281551845460399,4242.38284869726,194297,0.19
2010-06-01,12995513,14294000,1298487,0.2,46251,139440,93189,2.18948411090203,4133.02866801513,240548,0.2
2010-06-02,13002995,14294000,1291005,0.2,-3826,9003,12829,-0.306041019549116,4479.99422583245,236722,0.2
2010-06-03,13000830,14294000,1293170,0.19,-21818,150336,172154,-1.15373032359532,4399.9412027096,214904,0.19
2010-06-04,12995186,14294000,1298814,0.19,-4935,7352,12286,-0.296194388266519,3745.0086193132,209969,0.19
2010-06-07,12996856,14294000,1297144,0.19,-683,11012,11695,-0.0975468341509787,4703.86054105376,209286,0.19
2010-06-08,13001626,14294000,1292374,0.19,-6878,5028,11907,-0.391749417941657,4290.60496446726,202408,0.19
2010-06-09,12990836,14294000,1303164,0.18,-8886,10545,19430,-0.48091365404966,4535.70358763893,193522,0.18
2010-06-10,12986066,14294000,1307934,0.18,-11557,145495,157052,-0.599968309521479,4357.2704462844,181965,0.18
2010-06-11,12985886,14294000,1308114,0.18,-3294,9827,13122,-0.127823664374209,4150.60376751632,178671,0.18
2010-06-14,12987878,14294000,1306122,0.18,8392,20496,12104,0.513172060828113,4167.12529999675,187063,0.18
2010-06-15,13023168,14294000,1270832,0.19,72583,130779,58196,3.37188310646357,4225.0528152987,259646,0.19
2010-06-16,13017765,14294000,1276235,0.19,648,19211,18563,-0.00242999933127379,4157.88766683276,260294,0.19
2010-06-17,12983630,14294000,1310370,0.19,-45200,122281,167481,-2.02657651112539,4089.25066097127,215094,0.19
2010-06-18,12983225,14294000,1310775,0.18,2460,12840,10380,0.123895802099128,4003.75346859688,217554,0.18
2010-06-21,12984872,14294000,1309128,0.17,8005,18886,10881,0.364133687575655,4182.95352250399,225559,0.17
2010-06-22,12991488,14294000,1302512,0.18,2343,13226,10882,0.118905051455109,4681.22181242706,227902,0.18
2010-06-23,12986702,14294000,1307298,0.17,-7177,11589,18766,-0.301237217439464,3697.48215091692,220725,0.17
2010-06-24,12982910,14294000,1311090,0.16,-10044,117849,127893,-0.434034374867767,4236.89053097063,210681,0.16
2010-06-25,12983153,14294000,1310847,0.16,-4088,8442,12530,-0.189491365543828,4005.78919596871,206593,0.16
2010-06-28,12983813,14294000,1310187,0.17,-364,12959,13322,0.0692078175303479,4622.47996819339,206229,0.17
2010-06-29,12982455,14294000,1311545,0.15,-3751,7382,11133,-0.142035858731443,4373.27977936142,202478,0.15
2010-06-30,13149560,14294000,1144440,0.09,59503,129875,70372,2.85042908216666,3906.07111694538,261981,0.09
2010-07-01,13125955,14294000,1168045,0.17,-40257,164764,205021,-1.83248488813403,4542.40690367689,221724,0.17
2010-07-02,13122985,14294000,1171015,0.18,-23483,9476,32960,-1.05461519753258,4174.10282880008,198241,0.18
2010-07-06,13125364,14294000,1168636,0.18,-1295,11288,12583,-0.0407377323544404,4458.33771072326,196946,0.18
2010-07-07,13129727,14294000,1164273,0.18,-6069,7301,13370,-0.26172623168967,3890.10618158017,190877,0.18
2010-07-08,13139931,14294000,1154069,0.17,10006,135115,125109,0.460792403816048,4067.82364143012,200883,0.17
2010-07-09,13141568,14294000,1152432,0.18,-6279,6895,13173,-0.294454158238775,3946.08102717315,194604,0.18
2010-07-12,13142285,14294000,1151715,0.17,-378,12193,12571,-0.0263319386242733,4526.95827756623,194226,0.17
2010-07-13,13147070,14294000,1146930,0.17,-6795,3820,10615,-0.320472355361994,4779.69991378884,187431,0.17
2010-07-14,13137301,14294000,1156699,0.17,-5073,12961,18034,-0.199031078027016,3770.96661684996,182358,0.17
2010-07-15,13187988,14294000,1106012,0.19,42104,218074,175970,1.91619090663786,4088.89104770474,224462,0.19
2010-07-16,13187679,14294000,1106321,0.19,3135,13078,9944,0.117534566623432,4011.02482055535,227597,0.19
2010-07-19,13190719,14294000,1103281,0.19,1889,10634,8745,0.0610623855805025,3999.05230995767,229486,0.19
2010-07-20,13193840,14294000,1100160,0.18,-4455,4915,9370,-0.232586671329222,4647.56695478466,225031,0.18
2010-07-21,13185352,14294000,1108648,0.18,-6769,11560,18329,-0.327485761172109,3953.12817533595,218262,0.18
2010-07-22,13196976,14294000,1097024,0.18,3312,123638,120325,0.126341322136563,3968.25372042698,221574,0.18
2010-07-23,13196364,14294000,1097636,0.19,-4360,9458,13818,-0.230393913407755,3698.64800352348,217214,0.19
2010-07-26,13199918,14294000,1094082,0.19,2680,12310,9630,0.0982531756129556,4088.03171368123,219894,0.19
2010-07-27,13206185,14294000,1087815,0.19,-6007,4394,10402,-0.298739692907591,4401.90893754567,213887,0.19
2010-07-28,13195715,14294000,1098285,0.2,-9093,10290,19383,-0.400250590700568,3618.30899292114,204794,0.2
2010-07-29,13194320,14294000,1099680,0.19,-1464,153927,155391,-0.0307229917596384,3747.47416003883,203330,0.19
2010-07-30,13185208,14294000,1108792,0.18,-27683,10057,37740,-1.29279711761724,3664.69328141188,175647,0.18
2010-08-02,13244341,14294000,1049659,0.19,66846,134271,67424,2.83936535441414,4093.38001010691,242493,0.19
2010-08-03,13248675,14294000,1045325,0.19,-27239,6343,33582,-1.15682605795093,4348.51708677432,215254,0.19
2010-08-04,13249356,14294000,1044644,0.19,3164,14010,10847,0.116850084254193,4110.55799827017,218418,0.19
2010-08-05,13257906,14294000,1036094,0.19,-808,124983,125791,-0.0597410268068471,4398.82800219071,217610,0.19
2010-08-06,13257147,14294000,1036853,0.18,-6088,7760,13847,-0.289905972277274,4067.10444208864,211522,0.18
2010-08-09,13258335,14294000,1035665,0.18,437,12275,11838,-0.0167886166139719,4263.59238276236,211959,0.18
2010-08-10,13266933,14294000,1027067,0.18,-4031,7141,11171,-0.19356888981377,4622.08410698718,207928,0.18
2010-08-11,13254990,14294000,1039010,0.17,-6613,11605,18218,-0.252338039298136,3811.43614092499,201315,0.17
2010-08-12,13264134,14294000,1029866,0.18,-480,127290,127771,0.0492750494502159,4499.3402637198,200835,0.18
2010-08-13,13262520,14294000,1031480,0.19,-6128,9669,15797,-0.292961297249296,4177.48632429629,194707,0.19
2010-08-16,13304146,14294000,989854,0.2,23035,99690,76655,1.17910306166001,4540.16175923281,217742,0.2
2010-08-17,13311908,14294000,982092,0.2,-6187,4610,10797,-0.29914585334078,4360.04581889424,211555,0.2
2010-08-18,13300986,14294000,993014,0.19,-6968,11882,18850,-0.326864660816514,3920.14612782382,204587,0.19
2010-08-19,13310379,14294000,983621,0.19,-1976,125381,127357,-0.0780832929344691,4020.50095778963,202611,0.19
2010-08-20,13308908,14294000,985092,0.2,-7829,7862,15690,-0.381457198473281,3979.65048716593,194782,0.2
2010-08-23,13310497,14294000,983503,0.19,1934,14512,12577,0.11198039738457,4036.84964352705,196716,0.19
2010-08-24,13318537,14294000,975463,0.19,-8238,3716,11953,-0.399357397470162,4232.38148007208,188478,0.19
2010-08-25,13308607,14294000,985393,0.19,-8200,9720,17920,-0.391070629795768,3744.87632565409,180278,0.19
2010-08-26,13323339,14294000,970661,0.19,7250,189077,181828,0.535511183694753,4015.05155544199,187528,0.19
2010-08-27,13322389,14294000,971611,0.19,-6515,8262,14777,-0.34662998965523,4167.91106627159,181013,0.19
2010-08-30,13317057,14294000,976943,0.19,805,11684,10880,0.0787483629239109,4312.50288944003,181818,0.19
2010-08-31,13398794,14294000,895206,0.21,68083,120333,52250,3.54090260044432,4122.33150271227,249901,0.21
2010-09-01,13375948,14294000,918052,0.19,-29816,20468,50284,-1.56995803723577,4369.82544891306,220085,0.19
2010-09-02,13391169,14294000,902831,0.19,4258,129918,125659,0.189178480917835,4106.46986232198,224343,0.19
2010-09-03,13384471,14294000,909529,0.19,-28232,9422,37654,-1.41982969957418,3913.57607130269,196111,0.19
2010-09-07,13387965,14294000,906035,0.2,-2031,12423,14454,-0.1018093023477,4027.04449425756,194080,0.2
2010-09-08,13384566,14294000,909434,0.19,-15671,7788,23459,-0.770735650407607,4352.17257067325,178409,0.19
2010-09-09,13393678,14294000,900322,0.18,3329,133787,130459,0.166959535878595,3999.53847605303,181738,0.18
2010-09-10,13390961,14294000,903039,0.18,-2068,8954,11023,-0.0503506424829061,4221.54476315265,179670,0.18
2010-09-13,13392691,14294000,901309,0.18,1790,13457,11667,0.156354395372171,4530.55620118143,181460,0.18
2010-09-14,13389490,14294000,904510,0.19,4234,15283,11049,0.282864433771566,4063.6359436519,185694,0.19
2010-09-15,13447308,14294000,846692,0.21,103205,138946,35740,4.0607212009111,3814.20235800066,288899,0.21
2010-09-16,13414147,14294000,879853,0.21,-35828,128942,164770,-1.42881288535875,4234.70675986703,253071,0.21
2010-09-17,13417012,14294000,876988,0.21,-4084,10219,14303,-0.185627353129488,3943.2068323911,248987,0.21
2010-09-20,13418658,14294000,875342,0.21,3120,18257,15136,0.0875175487513064,4185.12838019698,252107,0.21
2010-09-21,13425993,14294000,868007,0.2,5989,18094,12105,0.195920331972236,4746.60151205952,258096,0.2
2010-09-22,13420442,14294000,873558,0.21,-6184,13545,19729,-0.277664730968701,3721.64757677487,251912,0.21
2010-09-23,13412726,14294000,881274,0.2,-15896,147431,163328,-0.646737749583819,4060.3205537502,236016,0.2
2010-09-24,13416083,14294000,877917,0.21,-5684,7311,12995,-0.246439555433481,3827.49304375593,230332,0.21
2010-09-27,13417486,14294000,876514,0.19,5470,13706,8236,0.156154468281662,4198.42280921308,235802,0.19
2010-09-28,13422133,14294000,871867,0.19,-7036,5671,12707,-0.289629685890158,4465.63854647662,228766,0.19
2010-09-29,13415875,14294000,878125,0.19,3454,14194,10739,0.133484310112788,3681.61071461504,232220,0.19
2010-09-30,13510840,14294000,783160,0.15,50046,229225,179179,2.01744216700496,4277.71350992746,282266,0.15
2010-10-01,13560080,14294000,733920,0.2,-58551,18778,77329,-2.27264224971123,4717.879270258,223715,0.2
2010-10-04,13566535,14294000,727465,0.2,4429,14777,10349,0.155446005196987,4662.00700495888,228144,0.2
2010-10-05,13573648,14294000,720352,0.2,-6151,6681,12832,-0.247751560965718,4427.66920589438,221993,0.2
2010-10-06,13573990,14294000,720010,0.19,1927,12297,10369,0.0591212658900504,4007.71664506647,223920,0.19
2010-10-07,13564957,14294000,729043,0.18,-23740,118328,142069,-0.908786909556725,4642.41393719751,200180,0.18
2010-10-08,13563350,14294000,730650,0.18,-2987,7084,10071,-0.110974494406666,4638.61153555434,197193,0.18
2010-10-12,13562025,14294000,731975,0.18,3928,18684,14756,0.144440615474146,4155.05244938531,201121,0.18
2010-10-13,13561676,14294000,732324,0.18,-11085,11298,22384,-0.401648399740406,4084.18366462004,190036,0.18
2010-10-14,13556297,14294000,737703,0.19,-8248,119862,128111,-0.289862669705642,4524.78215515259,181788,0.19
2010-10-15,13615292,14294000,678708,0.2,49215,83305,34089,1.79567884724529,4035.02681753839,231003,0.2
2010-10-18,13618307,14294000,675693,0.19,6483,19373,12889,0.207422893974472,3791.83851656611,237486,0.19
2010-10-19,13625643,14294000,668357,0.19,-6557,5354,11911,-0.275893416277338,4566.89733063613,230929,0.19
2010-10-20,13617667,14294000,676333,0.19,-4306,14449,18755,-0.18680110981579,3537.09758337054,226623,0.19
2010-10-21,13617622,14294000,676378,0.19,-9535,140331,149866,-0.378718820208927,4028.07029501563,217088,0.19
2010-10-22,13617279,14294000,676721,0.19,-4498,7208,11706,-0.196215731702742,4572.91145770394,212590,0.19
2010-10-25,13619060,14294000,674940,0.19,5690,13041,7351,0.182049291076329,4263.09509545086,218280,0.19
2010-10-26,13623465,14294000,670535,0.19,-6933,4656,11589,-0.284493836288488,4643.67677079136,211347,0.19
2010-10-27,13613623,14294000,680377,0.19,-9716,10442,20158,-0.376998169869224,4222.42244875075,201631,0.19
2010-10-28,13608517,14294000,685483,0.19,-8886,112660,121546,-0.300705886500051,4438.23641794658,192745,0.19
2010-10-29,13617337,14294000,676663,0.2,5864,23946,18081,0.262442528316762,3550.02592836496,198609,0.2
2010-11-01,13661615,14294000,632385,0.2,34226,126049,91823,1.3608970783738,4496.34804926829,232835,0.2
2010-11-02,13672516,14294000,621484,0.2,-4027,7526,11552,-0.197113747638436,4549.48898115849,228808,0.2
2010-11-03,13667270,14294000,626730,0.2,-18378,14047,32426,-0.758735519849434,4307.39067287031,210430,0.2
2010-11-04,13671973,14294000,622027,0.19,-6334,117701,124035,-0.283021890141373,4472.55722198926,204096,0.19
2010-11-05,13671879,14294000,622121,0.18,-5358,6773,12131,-0.234481998908602,4198.67222426631,198738,0.18
2010-11-08,13673762,14294000,620238,0.18,-659,11419,12078,-0.0453858331577811,4589.28957845554,198079,0.18
2010-11-09,13675758,14294000,618242,0.17,-7439,3747,11186,-0.310583498106373,4671.82321323424,190640,0.17
2010-11-10,13668174,14294000,625826,0.17,-7985,12789,20773,-0.320004140808748,3575.17177509397,182655,0.17
2010-11-12,13670599,14294000,623401,0.19,-6847,120184,127031,-0.22102748809321,4123.00880271939,175808,0.19
2010-11-15,13737680,14294000,556320,0.21,46698,104239,57541,2.49679216243384,4728.81060341984,222506,0.21
2010-11-16,13743816,14294000,550184,0.21,-928,11138,12066,-0.0127765175064014,4173.5680957665,221578,0.21
2010-11-17,13737976,14294000,556024,0.2,-8481,10727,19208,-0.394404282627213,4129.16289337197,213097,0.2
2010-11-18,13737059,14294000,556941,0.2,-10634,139962,150596,-0.48505063618467,4208.69909735342,202463,0.2
2010-11-19,13738318,14294000,555682,0.21,1226,12014,10787,0.12767975896573,4025.82077483724,203689,0.21
2010-11-22,13743310,14294000,550690,0.19,1106,11988,10882,0.0998308777003178,4687.1812523161,204795,0.19
2010-11-23,13745684,14294000,548316,0.2,4772,18038,13266,0.279954309961908,3909.46184367399,209567,0.2
2010-11-24,13736985,14294000,557015,0.2,-11144,10274,21418,-0.538833360136299,4739.959978734,198423,0.2
2010-11-26,13742922,14294000,551078,0.2,410,120168,119758,0.061214029165438,4041.90250897563,198833,0.2
2010-11-29,13739027,14294000,554973,0.2,879,12714,11836,0.0894499327369145,4322.39708728371,199712,0.2
2010-11-30,13809121,14294000,484879,0.2,54097,111497,57400,2.854569657222,4225.35505186082,253809,0.2
2010-12-01,13783281,14294000,510719,0.2,-33928,20573,54501,-1.91915042882272,4237.837980809,219881,0.2
2010-12-02,13789292,14294000,504708,0.19,-2866,122167,125033,-0.146878847128969,4366.44284368213,217015,0.19
2010-12-03,13781852,14294000,512148,0.18,-23779,8676,32455,-1.28213109825111,4223.04602425973,193236,0.18
2010-12-06,13783211,14294000,510789,0.18,37,11163,11126,0.0446677556511724,4510.7157418716,193273,0.18
2010-12-07,13786892,14294000,507108,0.17,-8197,4477,12674,-0.443363733987232,4537.63452850554,185076,0.17
2010-12-08,13796301,14294000,497699,0.17,8894,27834,18940,0.507283944031054,3540.0047861146,193970,0.17
2010-12-09,13794884,14294000,499116,0.16,-6149,113606,119755,-0.328530051604374,4605.7548000921,187821,0.16
2010-12-10,13795087,14294000,498913,0.16,6798,19226,12428,0.378624642277461,3780.9342164611,194619,0.16
2010-12-13,13796468,14294000,497532,0.17,2903,14759,11856,0.142558251642342,4838.32914488935,197522,0.17
2010-12-14,13801055,14294000,492945,0.19,-1631,10333,11964,-0.0479011834595933,4171.45637123809,195891,0.19
2010-12-15,13828266,14294000,465734,0.2,70080,122543,52463,3.59478778378417,3556.00727263259,265971,0.2
2010-12-16,13827224,14294000,466776,0.2,-1332,149815,151147,-0.112892032422492,4649.63022049083,264639,0.2
2010-12-17,13831802,14294000,462198,0.2,675,10684,10009,-0.015186322850423,4574.42017246839,265314,0.2
2010-12-20,13816909,14294000,477091,0.21,3718,14785,11067,0.12617836034789,4296.95387085479,269032,0.21
2010-12-21,13815940,14294000,478060,0.2,-1990,10250,12239,-0.174919504588166,4081.32055222326,267042,0.2
2010-12-22,13807004,14294000,486996,0.19,-2739,17908,20646,-0.203040761490483,4070.78873943504,264303,0.19
2010-12-23,13813627,14294000,480373,0.19,-4992,119508,124501,-0.323496578238026,4306.08920092805,259311,0.19
2010-12-23,13813627,14294000,480373,0.19,-4992,119508,124501,-0.323496578238026,4306.08920092805,259311,0.19
2010-12-27,13822511,14294000,471489,0.19,6572,13280,6708,0.260351735790786,4747.26712627949,265883,0.19
2010-12-28,13825756,14294000,468244,0.18,-7551,5199,12750,-0.482314104213447,3903.32018581821,258332,0.18
2010-12-29,13819491,14294000,474509,0.18,3323,14806,11483,0.0917214582547286,4402.36048254274,261655,0.18
2010-12-30,13819636,14294000,474364,0.19,-16958,123520,140479,-0.932319912096245,4269.42809150961,244697,0.19
2010-12-30,13819636,14294000,474364,0.19,-16958,123520,140479,-0.932319912096245,4269.42809150961,244697,0.19
2011-01-03,13945278,14294000,348722,0.19,-33570,30087,63657,-1.72018946544918,4000.23729018389,211127,0.19
2011-01-04,13961410,14294000,332590,0.18,-6783,6185,12969,-0.34775197628731,4241.7425068531,204344,0.18
2011-01-05,13958902,14294000,335098,0.18,5317,17620,12303,0.271663425372474,3806.84933460062,209661,0.18
2011-01-06,13959138,14294000,334862,0.17,-9234,113669,122903,-0.485707738595653,4516.22410158246,200427,0.17
2011-01-07,13956782,14294000,337218,0.17,-5023,8276,13299,-0.259280260188191,4403.75275272612,195404,0.17
2011-01-10,13961750,14294000,332250,0.17,-117,12994,13111,-0.0122224825316289,4647.10354645004,195287,0.17
2011-01-11,13966980,14294000,327020,0.17,-5514,6147,11661,-0.29871742301378,4842.30898378495,189773,0.17
2011-01-12,13957825,14294000,336175,0.16,-10275,9217,19491,-0.54293854950343,4283.46325243029,179498,0.16
2011-01-13,13954560,14294000,339440,0.16,-13498,139598,153096,-0.684938584510687,4461.88262636172,166000,0.16
2011-01-14,13955302,14294000,338698,0.16,-20868,14012,34880,-1.05844684518151,4300.84190613737,145132,0.16
2011-01-18,13999800,14294000,294200,0.19,50459,94921,44462,2.58468321519295,4195.91660786517,195591,0.19
2011-01-19,14000946,14294000,293054,0.18,2451,22804,20353,0.1305136623303,4260.4281172276,198042,0.18
2011-01-20,14003715,14294000,290285,0.18,-699,123290,123990,-0.0275330731226817,4288.78479255201,197343,0.18
2011-01-21,14007554,14294000,286446,0.17,-5326,9669,14995,-0.254900356289807,4101.95437043647,192017,0.17
2011-01-24,14009702,14294000,284298,0.18,6189,18482,12293,0.329384218923079,4600.08090370538,198206,0.18
2011-01-25,14014950,14294000,279050,0.17,1493,10856,9362,0.0746439500317752,4591.97158014476,199699,0.17
2011-01-26,14007504,14294000,286496,0.17,-1567,17662,19230,-0.079152674887047,4634.13519637202,198132,0.17
2011-01-27,14006870,14294000,287130,0.17,-12758,118508,131266,-0.630114718021646,4356.68905840058,185374,0.17
2011-01-28,14003989,14294000,290011,0.17,-7753,12040,19793,-0.332082254347444,3442.45253935538,177621,0.17
2011-01-31,14078501,14294000,215499,0.17,73487,131625,58137,3.53845977244371,4163.43346595053,251108,0.17
2011-02-01,14057308,14294000,236692,0.18,-33604,19401,53005,-1.58193282443411,4411.93765542951,217504,0.18
2011-02-02,14063993,14294000,230007,0.18,4332,15618,11285,0.173019602165793,3932.59594651821,221836,0.18
2011-02-03,14047880,14294000,246120,0.17,-40561,103428,143989,-1.83834351101438,4360.36391984569,181275,0.17
2011-02-04,14047292,14294000,246708,0.17,-19470,9929,29399,-0.855569986666939,4558.63089478855,161805,0.17
2011-02-07,14051536,14294000,242464,0.17,-1326,13322,14648,-0.0221911986170093,4639.25982011909,160479,0.17
2011-02-08,14057950,14294000,236050,0.16,-7984,4182,12166,-0.322229451602021,4170.04022695758,152495,0.16
2011-02-09,14046334,14294000,247666,0.15,-11043,9661,20704,-0.44038220764514,4534.98019412556,141452,0.15
2011-02-10,14030795,14294000,263205,0.15,-24277,129235,153512,-0.996754704378259,3817.13271598311,117175,0.15
2011-02-11,14030177,14294000,263823,0.15,-26809,6092,32900,-1.06564115455205,4493.01470424254,90366,0.15
2011-02-14,14029071,14294000,264929,0.15,4802,17481,12679,0.46688083632415,4296.39787293259,95168,0.15
2011-02-15,14085610,14294000,208390,0.16,15412,83108,67696,0.979084562820404,4324.2824991598,110580,0.16
2011-02-16,14077430,14294000,216570,0.15,-2048,17654,19702,0.0951782538564894,4522.50732281559,108532,0.15
2011-02-17,14071106,14294000,222894,0.15,-19827,104947,124774,-0.774413521650816,4242.86629111568,88705,0.15
2011-02-18,14072364,14294000,221636,0.15,-19324,9917,29241,-0.722227960535359,4394.08940771758,69381,0.15
2011-02-22,14076149,14294000,217851,0.15,-1059,16403,17463,0.192791895541783,4343.85895688403,68322,0.15
2011-02-23,14073070,14294000,220930,0.15,-16203,8018,24221,-0.551143085883146,4095.06846116,52119,0.15
2011-02-24,14067394,14294000,226606,0.15,-16092,116248,132340,-0.517793278013017,4266.58147943232,36027,0.15
2011-02-25,14085138,14294000,208862,0.15,2672,33610,30937,0.407696065067304,3585.58528086409,38699,0.15
2011-02-28,14142331,14294000,151669,0.16,53881,133114,79232,2.63142147834225,4486.46920981688,92580,0.16
2011-03-01,14120539,14294000,173461,0.15,-33636,20128,53765,-1.28953340771697,4729.15290201479,58944,0.15
2011-03-02,14126122,14294000,167878,0.16,-5460,13003,18463,-0.0690757859987731,4134.23242707895,53484,0.16
2011-03-03,14129652,14294000,164348,0.15,-22155,134198,156353,-0.804087145277605,4331.3805856537,31329,0.15
2011-03-04,14130208,14294000,163792,0.15,-20416,10684,31100,-0.69395041951823,4254.73230640969,10913,0.15
2011-03-07,14133795,14294000,160205,0.14,5073,20213,15141,0.434172555702438,4414.39424838321,15986,0.14
2011-03-08,14140818,14294000,153182,0.14,66,11877,11811,0.203874650074008,4286.94906081236,16052,0.14
2011-03-09,14130320,14294000,163680,0.14,-8410,11098,19508,-0.166664300143522,3770.44614976185,7642,0.14
2011-03-10,14111009,14294000,182991,0.14,-26702,135896,162597,-0.951190615851315,4031.82815873734,-19060,0.14
2011-03-11,14111950,14294000,182050,0.13,-12799,9044,21843,-0.332503924116336,4574.2248697162,-31859,0.13
2011-03-14,14113665,14294000,180335,0.14,10087,21767,11680,0.651469931165813,4039.05531653133,-21772,0.14
2011-03-15,14185601,14294000,108399,0.14,75207,91706,16499,3.00333222982175,4057.42417106817,53435,0.14
2011-03-16,14180514,14294000,113486,0.14,1964,23320,21356,0.224486515298065,4414.08775633595,55399,0.14
2011-03-17,14171379,14294000,122621,0.14,-23223,110304,133528,-0.777420433402518,4468.42694916231,32176,0.14
2011-03-18,14172526,14294000,121474,0.15,-14154,9845,23999,-0.393421412193833,4303.69406735618,18022,0.15
2011-03-21,14175900,14294000,118100,0.14,-623,12862,13486,0.152201217440987,4686.90560794409,17399,0.14
2011-03-22,14181281,14294000,112719,0.14,-7921,5053,12974,-0.130541715604856,4372.7782218834,9478,0.14
2011-03-23,14172734,14294000,121266,0.14,-8765,11436,20200,-0.154571218767858,4016.97447891889,713,0.14
2011-03-24,14157789,14294000,136211,0.13,-24376,117218,141594,-0.762241045225893,4348.08192441547,-23663,0.13
2011-03-25,14159265,14294000,134735,0.13,-9922,6877,16798,-0.180171124875043,3824.93047389867,-33585,0.13
2011-03-28,14159342,14294000,134658,0.13,1688,12968,11279,0.280283097794963,4258.35442730774,-31897,0.13
2011-03-29,14163533,14294000,130467,0.13,-7498,5792,13290,-0.0111274457102911,4134.28010162956,-39395,0.13
2011-03-30,14157943,14294000,136057,0.13,7595,19173,11578,0.663436224111213,4397.64170232904,-31800,0.13
2011-03-31,14217862,14294000,76138,0.1,51823,231607,179784,2.502228591548,4092.6494351711,20023,0.1
2011-04-01,14198936,14294000,95064,0.11,-62766,20855,83620,-2.3958969739116,4331.35544265706,-42743,0.11
2011-04-04,14191736,14294000,102264,0.09,-154,15128,15282,0.208840735361199,4463.27886760395,-42897,0.09
2011-04-05,14209963,14294000,84037,0.09,-9645,5337,14982,-0.181723248899628,4601.39647841688,-52542,0.09
2011-04-06,14207595,14294000,86405,0.1,2483,13335,10852,0.317133114449708,3955.91367920252,-50059,0.1
2011-04-07,14211999,14294000,82001,0.1,-6022,136312,142334,-0.0455747059882685,4660.45982709861,-56081,0.1
2011-04-08,14213150,14294000,80850,0.09,-11523,8441,19964,-0.292561372178208,4141.66410309397,-67604,0.09
2011-04-11,14215569,14294000,78431,0.09,600,13855,13255,0.194332396598806,4595.76170587019,-67004,0.09
2011-04-12,14220816,14294000,73184,0.08,-80,10109,10189,0.170668968310262,4434.22340035837,-67084,0.08
2011-04-13,14211984,14294000,82016,0.08,855,20101,19246,0.2283720006077,4028.22612462497,-66229,0.08
2011-04-14,14218621,14294000,75379,0.09,4766,118233,113466,0.389584360306685,4577.77943283797,-61463,0.09
2011-04-15,14253179,14294000,40821,0.12,28651,103032,74382,1.34440185131958,4341.57257104871,-32812,0.12
2011-04-18,14257042,14294000,36958,0.1,30532,42447,11915,1.34670287024752,4100.36203279662,-2280,0.1
2011-04-19,14268365,14294000,25635,0.11,17743,29049,11306,0.787788990443603,4058.13446105082,15463,0.11
2011-04-20,14262707,14294000,31293,0.1,6710,25951,19240,0.30936298566487,3873.88422553606,22173,0.1
2011-04-21,14238692,14294000,55308,0.1,-23129,116588,139717,-0.915653950240872,4111.38690730845,-956,0.1
2011-04-22,14241159,14294000,52841,0.1,1168,20394,19226,0.0878594928081689,3810.39348549277,212,0.1
2011-04-25,14246886,14294000,47114,0.1,16169,25947,9777,0.794644373797483,4285.90640373624,16381,0.1
2011-04-26,14252380,14294000,41620,0.09,24310,34920,10609,1.09993842844499,4620.2453057943,40691,0.09
2011-04-27,14243111,14294000,50889,0.09,-5530,17449,22979,-0.225253674695704,3885.76887889112,35161,0.09
2011-04-28,14230573,14294000,63427,0.09,-10707,100821,111528,-0.472312433958921,4321.68876043422,24454,0.09
2011-04-29,14235938,14294000,58062,0.09,-16028,32363,48391,-0.718731205565628,4060.45244048352,8426,0.09
2011-05-02,14268984,14294000,25016,0.09,45313,138880,93568,1.90137655051849,4255.64919002629,53739,0.09
2011-05-03,14280140,14294000,13860,0.09,-23788,10435,34224,-1.02006029000396,4252.19805008455,29951,0.09
2011-05-04,14282174,14294000,11826,0.09,4445,16237,11792,0.159829532051746,3993.77982876309,34396,0.09
2011-05-05,14269975,14294000,24025,0.09,-21246,121037,142283,-0.939177071725823,3768.92987675189,13150,0.09
2011-05-06,14271008,14294000,22992,0.09,-2319,13435,15753,-0.144823544533889,4133.09426766398,10831,0.09
2011-05-09,14274144,14294000,19856,0.09,1520,13185,11665,0.0285787974482928,4352.06751185891,12351,0.09
2011-05-10,14279895,14294000,14105,0.09,-7008,4060,11068,-0.290255760266487,4608.51847996281,5343,0.09
2011-05-11,14270443,14294000,23557,0.09,-8465,11318,19783,-0.349615612129474,4074.23557412824,-3122,0.09
2011-05-12,14256186,14294000,37814,0.09,-13196,100108,113304,-0.604933474728646,4586.17041707397,-16318,0.09
2011-05-13,14256785,14294000,37215,0.09,-5639,11577,17216,-0.23535666409761,4323.81230926069,-21957,0.09
2011-05-16,14293975,14294000,25,0.1,58043,97466,39423,2.63962895035134,3685.17182386772,36086,0.1
2011-05-17,14293975,14294000,25,0.09,-6079,4373,10452,-0.302453006077858,4722.85272977497,30007,0.09
2011-05-18,14293975,14294000,25,0.1,-11385,10735,22120,-0.54207996781306,4180.55549614512,18622,0.1
2011-05-19,14293975,14294000,25,0.09,-19968,95524,115492,-0.94543118627803,4476.48476104555,-1346,0.09
2011-05-20,14293975,14294000,25,0.1,-4398,6925,11324,-0.235183518978926,4431.42986920861,-5744,0.1
2011-05-23,14293975,14294000,25,0.1,3232,13258,10027,0.115283098729836,4196.21476244242,-2512,0.1
2011-05-24,14293975,14294000,25,0.1,-6480,9179,15659,-0.334358146519041,4498.99256262682,-8992,0.1
2011-05-25,14293975,14294000,25,0.09,-8335,11253,19588,-0.401307847404023,4202.9794831422,-17327,0.09
2011-05-26,14293975,14294000,25,0.09,-19543,86132,105675,-0.896413659873577,3985.95374846731,-36870,0.09
2011-05-27,14293975,14294000,25,0.1,1140,15901,14762,0.054816962878106,4078.99073213671,-35730,0.1
2011-05-31,14293975,14294000,25,0.1,57318,135555,78238,2.81609184753691,4592.1252937493,21588,0.1
2011-06-01,14293975,14294000,25,0.1,-38640,16859,55499,-1.90827151906796,4332.72396851006,-17052,0.1
2011-06-02,14293975,14294000,25,0.1,-10845,118944,129789,-0.54818007804057,4157.97432556569,-27897,0.1
2011-06-03,14293975,14294000,25,0.11,-25553,8338,33891,-1.20966056653165,4029.70210279886,-53450,0.11
2011-06-06,14293975,14294000,25,0.1,-246,11271,11517,-0.0281439050146322,4450.14094979203,-53696,0.1
2011-06-07,14293975,14294000,25,0.09,-6635,4656,11291,-0.32199615178104,4447.54599715679,-60331,0.09
2011-06-08,14293975,14294000,25,0.09,-7186,11438,18624,-0.339156877996668,4310.56094644489,-67517,0.09
2011-06-09,14293975,14294000,25,0.09,237,102174,101937,0.0124447573528431,4323.73009450853,-67280,0.09
2011-06-10,14293975,14294000,25,0.09,-3675,8742,12417,-0.162550039201551,4354.34500778537,-70955,0.09
2011-06-13,14293975,14294000,25,0.1,17005,28092,11087,0.842215362367302,4619.42232800211,-53950,0.1
2011-06-14,14293975,14294000,25,0.1,4882,15412,10531,0.299240540530487,4056.5224335591,-49068,0.1
2011-06-15,14293975,14294000,25,0.1,84831,125224,40393,3.48165325920801,4015.13226363023,35763,0.1
2011-06-16,14293975,14294000,25,0.1,-7711,97899,105610,-0.324280655651088,4282.19206984179,28052,0.1
2011-06-17,14293975,14294000,25,0.1,-1351,9638,10988,-0.0853196058114878,4158.34680024539,26701,0.1
2011-06-20,14293975,14294000,25,0.09,7208,17293,10085,0.265667969565855,4371.50662779154,33909,0.09
2011-06-21,14293975,14294000,25,0.09,9628,19785,10157,0.37482311065938,4250.62039244096,43537,0.09
2011-06-22,14293975,14294000,25,0.09,-4847,14112,18959,-0.203444336730878,4336.85080023421,38690,0.09
2011-06-23,14293975,14294000,25,0.08,-16500,86124,102624,-0.682300480860042,4480.52866380105,22190,0.08
2011-06-24,14293975,14294000,25,0.08,-5638,8232,13871,-0.229902009882019,4165.75536882054,16552,0.08
2011-06-27,14293975,14294000,25,0.08,3312,14378,11066,0.128605723946176,4261.85541493113,19864,0.08
2011-06-28,14293975,14294000,25,0.08,-7336,3637,10973,-0.281614348378458,4660.82747064415,12528,0.08
2011-06-29,14293975,14294000,25,0.07,2034,12521,10487,0.109501085038657,3910.97061593796,14562,0.07
2011-06-30,14293975,14294000,25,0.07,24391,230943,206552,1.08268488922124,4202.45700430306,38953,0.07
2011-07-01,14293975,14294000,25,0.08,-63177,20161,83338,-2.55669379646045,4092.79307228446,-24224,0.08
2011-07-05,14293975,14294000,25,0.08,4470,15722,11253,0.214897226148293,4226.69898853497,-19754,0.08
2011-07-06,14293975,14294000,25,0.07,-3988,7399,11386,-0.126664238763711,4535.49273525901,-23742,0.07
2011-07-07,14293975,14294000,25,0.07,-10045,92523,102568,-0.371812164493893,4002.11193641399,-33787,0.07
2011-07-08,14293975,14294000,25,0.07,-5217,7541,12758,-0.177300532539083,4233.8199220727,-39004,0.07
2011-07-11,14293975,14294000,25,0.07,730,11937,11207,0.0526637808668981,4323.20918085495,-38274,0.07
2011-07-12,14293975,14294000,25,0.06,-5951,4349,10300,-0.222115906598347,4515.15320382025,-44225,0.06
2011-07-13,14293975,14294000,25,0.06,-7357,10148,17505,-0.230952381385631,3974.53207658182,-51582,0.06
2011-07-14,14293975,14294000,25,0.06,-3611,107144,110756,-0.0662413966024145,4221.48124985261,-55193,0.06
2011-07-15,14293975,14294000,25,0.06,61879,82246,20368,2.5399033489078,4022.3102526103,6686,0.06
2011-07-18,14293975,14294000,25,0.06,9609,18012,8403,0.377018987899807,4607.1671480595,16295,0.06
2011-07-19,14293975,14294000,25,0.06,-5451,3634,9085,-0.241159035110483,5130.74710508608,10844,0.06
2011-07-20,14293975,14294000,25,0.06,-5415,12222,17637,-0.230670422557382,4188.89839469891,5429,0.06
2011-07-21,14293975,14294000,25,0.06,-12926,86545,99471,-0.531235674058231,4557.68543693655,-7497,0.06
2011-07-22,14293975,14294000,25,0.06,-6097,6975,13071,-0.253856069913379,3847.26678769673,-13594,0.06
2011-07-25,14293975,14294000,25,0.06,4090,15315,11224,0.140838455195095,4323.14254186715,-9504,0.06
2011-07-26,14293975,14294000,25,0.06,-6534,4453,10987,-0.290230394222,4068.43191615015,-16038,0.06
2011-07-27,14293975,14294000,25,0.07,-8225,10581,18805,-0.315784823330664,3936.34267637778,-24263,0.07
2011-07-28,14293975,14294000,25,0.08,-20193,112245,132438,-0.894586393685237,4568.49399476006,-44456,0.08
2011-07-29,14293975,14294000,25,0.11,13600,25907,12307,0.625609111614857,4114.96473128052,-30856,0.11
2011-08-01,14293975,14294000,25,0.17,1763,127249,125486,0.0537685048498186,4138.73952775135,-29093,0.17
2011-08-02,14532332,14694000,161668,0.16,-14907,11153,26060,-0.701248423558083,3515.63380950572,-44000,0.16
2011-08-03,14526246,14694000,167754,0.12,-19713,12401,32114,-0.900048431898354,4364.63555261409,-63713,0.12
2011-08-04,14516592,14694000,177408,0.09,-19534,82205,101739,-0.870117745220572,4495.88055352756,-83247,0.09
2011-08-05,14536130,14694000,157870,0.08,15280,27965,12685,0.691020364456035,3982.52448641821,-67967,0.08
2011-08-08,14539393,14694000,154607,0.11,1408,13136,11728,0.0586575721392404,4641.03961636129,-66559,0.11
2011-08-09,14543668,14694000,150332,0.1,-6576,3581,10157,-0.277333370825013,4180.66139096113,-73135,0.1
2011-08-10,14533644,14694000,160356,0.1,-8283,10051,18334,-0.339764373540239,4155.40633382662,-81418,0.1
2011-08-11,14539596,14694000,154404,0.09,9564,113379,103816,0.713482083171281,4596.77117081386,-71854,0.09
2011-08-12,14538888,14694000,155112,0.1,-1585,8336,9921,0.0555038896057552,4567.86688016635,-73439,0.1
2011-08-15,14567295,14694000,126705,0.1,-1845,92175,94020,0.0410711395721811,4466.24370021191,-75284,0.1
2011-08-16,14543981,14694000,150019,0.09,-1225,10127,11352,0.0898717975853675,4401.94596326353,-76509,0.09
2011-08-17,14564943,14694000,129057,0.09,-10596,8537,19133,-0.430971962925701,4488.83110319556,-87105,0.09
2011-08-18,14571943,14694000,122057,0.09,1108,99429,98320,0.248250328826278,4153.15456802092,-85997,0.09
2011-08-19,14590997,14694000,103003,0.09,15177,29533,14356,1.02245734217499,3869.17560638127,-70820,0.09
2011-08-22,14564225,14694000,129775,0.09,2747,14885,12138,0.283906472356058,3934.34880031495,-68073,0.09
2011-08-23,14601090,14694000,92910,0.08,-6994,4107,11101,-0.269881137327799,4350.58150136278,-75067,0.08
2011-08-24,14590918,14694000,103082,0.08,-10061,9444,19505,-0.444369574531036,3691.82912165393,-85128,0.08
2011-08-25,14605337,14694000,88663,0.08,8730,127492,118763,0.638864429652826,4075.88162592726,-76398,0.08
2011-08-26,14605628,14694000,88372,0.09,-3601,7315,10917,-0.0376177379721554,3987.51129241572,-79999,0.09
2011-08-29,14576624,14694000,117376,0.09,3677,13283,9606,0.367766507228027,4020.1403200457,-76322,0.09
2011-08-30,14574487,14694000,119513,0.08,-7412,3876,11288,-0.429278672696288,4664.25448227226,-83734,0.08
2011-08-31,14638920,14694000,55080,0.08,30190,128028,97838,2.14314281556293,4137.71611827066,-53544,0.08
2011-09-01,14652045,14694000,41955,0.08,-1362,134925,136288,-0.0580956555266248,4364.1230071377,-54906,0.08
2011-09-02,14649503,14694000,44497,0.08,-24891,10416,35307,-1.60755352151739,4443.96218962956,-79797,0.08
2011-09-06,14653307,14694000,40693,0.09,-3564,12332,15896,-0.164074658843705,4166.20912640264,-83361,0.09
2011-09-07,14672449,14694000,21551,0.09,10182,23036,12854,0.730153089689559,3954.66374546339,-73179,0.09
2011-09-08,14640241,14694000,53759,0.09,-8144,103040,111184,-0.495151999697694,4077.32114543555,-81323,0.09
2011-09-09,14666438,14694000,27562,0.09,-4115,6562,10677,-0.224695605417841,4083.77438823061,-85438,0.09
2011-09-12,14642991,14694000,51009,0.09,3535,14072,10537,0.522366485830676,4903.88849500359,-81903,0.09
2011-09-13,14672610,14694000,21390,0.09,5488,16849,11361,0.715307231176387,3730.81465496244,-76415,0.09
2011-09-14,14638662,14694000,55338,0.08,-3425,19120,22546,-0.106207677246092,4040.72986335036,-79840,0.08
2011-09-15,14651718,14694000,42282,0.09,40639,197107,156467,3.25605144289531,3633.72291696843,-39201,0.09
2011-09-16,14653786,14694000,40214,0.09,3032,16873,13841,0.295309595716129,4090.16822916334,-36169,0.09
2011-09-19,14684284,14694000,9716,0.09,4433,17311,12878,0.385094494358589,4073.33571272629,-31736,0.09
2011-09-20,14666678,14694000,27322,0.09,15257,26772,11515,1.19506107674834,4253.31733492662,-16479,0.09
2011-09-21,14660003,14694000,33997,0.08,-5309,14600,19909,-0.400450446631939,3993.03148980464,-21788,0.08
2011-09-22,14681588,15194000,512412,0.08,-14659,122777,137436,-1.10068886713407,3706.70759087977,-36447,0.08
2011-09-23,14654847,15194000,539153,0.08,-2659,9635,12294,-0.220870518362579,3627.37609570369,-39106,0.08
2011-09-26,14658843,15194000,535157,0.08,2456,12938,10482,0.208712230498852,4036.93066839506,-36650,0.08
2011-09-27,14662254,15194000,531746,0.08,-4089,7112,11201,-0.304490811890638,4575.28597796452,-40739,0.08
2011-09-28,14656740,15194000,537260,0.08,-10354,11615,21969,-0.82360758890575,3830.33422916889,-51093,0.08
2011-09-29,14649962,15194000,544038,0.08,-2826,99041,101867,-0.256898449797539,4187.24362901541,-53919,0.08
2011-09-30,14746553,15194000,447447,0.06,13976,132427,118451,1.1016728624759,4305.441570186,-39943,0.06
2011-10-03,14793341,15194000,400659,0.08,-21935,25116,47051,-1.83741474007062,4012.17213574211,-61878,0.08
2011-10-04,14813111,15194000,380889,0.07,-5359,5474,10834,-0.443313660586964,4607.10785522572,-67237,0.07
2011-10-05,14814312,15194000,379688,0.07,2856,13469,10612,0.219563954195494,4243.98976808231,-64381,0.07
2011-10-06,14793038,15194000,400962,0.07,-6556,97252,103808,-0.568994880405568,4621.28534239913,-70937,0.07
2011-10-07,14816604,15194000,377396,0.07,-3039,7862,10901,-0.250981228059167,4490.58413733051,-73976,0.07
2011-10-11,14819622,15194000,374378,0.07,410,13564,13154,0.0347360604584846,4042.27721799765,-73566,0.07
2011-10-12,14824537,15194000,369463,0.07,-4795,16743,21538,-0.395959842261888,4145.89898421339,-78361,0.07
2011-10-13,14830206,15194000,363794,0.07,6821,107184,100364,0.559768224799779,4073.89307304879,-71540,0.07
2011-10-14,14830380,15194000,363620,0.07,-8314,10567,18881,-0.712906487942541,4173.42295811263,-79854,0.07
2011-10-17,14892952,15194000,301048,0.07,68396,94758,26362,4.13900572386951,3879.28986955905,-11458,0.07
2011-10-18,14899120,15194000,294880,0.07,-6956,5423,12378,-0.517113632034788,4326.9157440779,-18414,0.07
2011-10-19,14887675,15194000,306325,0.07,-9303,12469,21772,-0.641657842314342,4251.36123410575,-27717,0.07
2011-10-20,14896713,15194000,297287,0.07,444,126538,126094,-0.0468733766646643,4915.6255210799,-27273,0.07
2011-10-21,14895589,15194000,298411,0.07,-3604,8052,11656,-0.311288307176219,4448.09074362159,-30877,0.07
2011-10-24,14897057,15194000,296943,0.07,2570,12808,10239,0.0860676287119434,4457.669293761,-28307,0.07
2011-10-25,14900008,15194000,293992,0.07,-4287,7331,11618,-0.344224439807269,4386.10906310959,-32594,0.07
2011-10-26,14893413,15194000,300587,0.08,-8239,11887,20126,-0.571797228317852,4787.80456066359,-40833,0.08
2011-10-27,14895979,15194000,298021,0.07,-5177,94774,99951,-0.384074017834628,4299.25892248184,-46010,0.07
2011-10-28,14894272,15194000,299728,0.07,-5964,10525,16488,-0.39382142798751,3711.3550192041,-51974,0.07
2011-10-31,14948905,15194000,245095,0.09,53184,132441,79257,2.97558679864469,4407.24210456539,1210,0.09
2011-11-01,14927036,15194000,266964,0.08,-36244,16726,52970,-2.08423640268565,4550.4344749827,-35034,0.08
2011-11-02,14933174,15194000,260826,0.08,2887,13440,10552,0.0896953168400187,4364.40752974723,-32147,0.08
2011-11-03,14928437,15194000,265563,0.09,-22507,102501,125007,-1.25943108033068,4981.86376125585,-54654,0.09
2011-11-04,14927880,15194000,266120,0.08,-1639,9594,11232,-0.124514037119477,4697.09579877366,-56293,0.08
2011-11-07,14931741,15194000,262259,0.08,984,12518,11534,0.0126991362090077,4662.03032410313,-55309,0.08
2011-11-08,14937682,15194000,256318,0.08,-6997,4196,11193,-0.411201803367034,4624.34411402532,-62306,0.08
2011-11-09,14928548,15194000,265452,0.08,-9513,9621,19133,-0.527375244898747,4197.8831047459,-71819,0.08
2011-11-10,14934856,15194000,259144,0.08,-3916,100097,104013,-0.220091697884461,4324.19508052591,-75735,0.08
2011-11-14,14933155,15194000,260845,0.08,12921,31009,18088,0.786695027740652,4284.85445956832,-62814,0.08
2011-11-15,14988883,15194000,205117,0.09,16021,90228,74207,0.937803196781506,4180.60802471952,-46793,0.09
2011-11-16,14982276,15194000,211724,0.08,-4450,15121,19571,-0.228219183380467,4533.0961845359,-51243,0.08
2011-11-17,14994607,15194000,199393,0.08,3426,127030,123604,0.244924597839272,3915.35427201637,-47817,0.08
2011-11-18,14995471,15194000,198529,0.08,-2273,8620,10893,-0.0911580659988034,4581.1028986756,-50090,0.08
2011-11-21,14997569,15194000,196431,0.08,1451,12329,10878,0.103126999063239,4125.64450943776,-48639,0.08
2011-11-22,15003278,15194000,190722,0.08,-4926,5622,10548,-0.26791181105642,4022.14156610353,-53565,0.08
2011-11-23,14991174,15194000,202826,0.09,-7848,13278,21126,-0.423447749723922,4852.89130599252,-61413,0.09
2011-11-25,15004172,15194000,189828,0.07,3794,105280,101486,0.246896185659138,4418.52964518705,-57619,0.07
2011-11-28,15006988,15194000,187012,0.08,-660,10985,11646,-0.0282557972408471,4509.18667595071,-58279,0.08
2011-11-29,15009484,15194000,184516,0.08,-4554,7455,12008,-0.254636600822911,3796.2131151811,-62833,0.08
2011-11-30,15067516,15194000,126484,0.1,52401,131667,79265,2.74508661069364,4317.61725835935,-10432,0.1
2011-12-01,15045453,15194000,148547,0.08,-36816,112562,149379,-1.91485529004157,4709.37089815075,-47248,0.08
2011-12-02,15030398,15194000,163602,0.08,-21936,9049,30985,-1.11004991427382,4150.27502349361,-69184,0.08
2011-12-05,15025169,15194000,168831,0.08,123,11763,11639,0.0121754264751207,4115.54812286132,-69061,0.08
2011-12-06,15028666,15194000,165334,0.08,-7135,4602,11736,-0.355204224073473,4046.42862640272,-76196,0.08
2011-12-07,15003445,15194000,190555,0.08,1930,12322,10392,0.0982689172818671,3655.22100128761,-74266,0.08
2011-12-08,15008207,15194000,185793,0.07,-3062,98137,101199,-0.150508227015004,4592.9382740989,-77328,0.07
2011-12-09,15009496,15194000,184504,0.07,-3387,8380,11767,-0.168837332380052,4227.22420537871,-80715,0.07
2011-12-12,15011088,15194000,182912,0.07,16986,28024,11039,0.845112183930541,4296.46686077227,-63729,0.07
2011-12-13,15017350,15194000,176650,0.07,-4440,5848,10288,-0.238575524862633,4012.7141434228,-68169,0.07
2011-12-14,15008369,15194000,185631,0.07,-2154,17657,19811,-0.0414161903910775,4679.58839960124,-70323,0.07
2011-12-15,15055152,15194000,138848,0.07,81126,242974,161847,3.82988971335242,4157.35541588258,10803,0.07
2011-12-16,15056557,15194000,137443,0.07,6836,16525,9689,0.272191166568727,4170.14682509587,17639,0.07
2011-12-19,15061133,15194000,132867,0.07,4980,15558,10578,0.178109565155206,4600.33793651713,22619,0.07
2011-12-20,15089063,15194000,104937,0.07,-4657,5779,10436,-0.280381086348348,4518.58260567246,17962,0.07
2011-12-21,15080931,15194000,113069,0.07,-7357,14340,21697,-0.396533064822664,4182.5860986973,10605,0.07
2011-12-22,15080819,15194000,113181,0.07,-4787,98967,103753,-0.273551606090348,4121.74002977091,5818,0.07
2011-12-23,15085670,15194000,108330,0.08,-2961,11587,14549,-0.193313808197089,4113.29286427572,2857,0.08
2011-12-27,15087704,15194000,106296,0.07,2897,15959,13062,0.0765320965394465,4286.11552814841,5754,0.07
2011-12-28,15082333,15194000,111667,0.07,-10336,11791,22128,-0.548757160009048,4268.28604685508,-4582,0.07
2011-12-29,15083022,15194000,110978,0.07,-464,106047,106511,-0.0159987949186392,4588.58097190344,-5046,0.07
2011-12-30,15180337,15194000,13663,0.04,-7256,32358,39613,-0.426205790154819,4427.24094265104,-12302,0.04
2012-01-03,15183641,15194000,10359,0.07,2715,136068,133353,0.117172841942505,3716.88376762894,-9587,0.07
2012-01-04,15193975,15194000,25,0.07,-1421,10912,12333,-0.139743922986303,4493.6461522981,-11008,0.07
2012-01-05,15193975,15194000,25,0.07,-1502,101078,102580,-0.144444432957126,4274.30522220158,-12510,0.07
2012-01-06,15193975,15194000,25,0.07,-5247,8365,13611,-0.343574461807361,3991.33799133963,-17757,0.07
2012-01-09,15193975,15194000,25,0.08,610,13508,12897,-0.0288987451725421,4657.80051403787,-17147,0.08
2012-01-10,15193975,15194000,25,0.08,-6381,5920,12301,-0.423509941009983,4402.45895026066,-23528,0.08
2012-01-11,15193975,15194000,25,0.08,-8444,11885,20329,-0.530924738882141,4289.21556782841,-31972,0.08
2012-01-12,15193975,15194000,25,0.08,-673,128698,129370,-0.0798945987719629,4208.71739190464,-32645,0.08
2012-01-13,15193975,15194000,25,0.09,-130,13103,13233,-0.0271569152950846,4354.28602743666,-32775,0.09
2012-01-17,15193975,15194000,25,0.09,46563,104684,58121,2.35053312514727,4112.13670205031,13788,0.09
2012-01-18,15193975,15194000,25,0.09,-3624,19816,23440,-0.265166506340154,4380.25864859273,10164,0.09
2012-01-19,15193975,15194000,25,0.1,4440,103097,98658,0.147556310837562,4202.5703491652,14604,0.1
2012-01-20,15193975,15194000,25,0.09,-5966,10722,16688,-0.385974570247242,4178.98473658034,8638,0.09
2012-01-23,15193975,15194000,25,0.09,8690,20557,11867,0.360822358076348,4500.33579240977,17328,0.09
2012-01-24,15193975,15194000,25,0.09,3314,13488,10174,0.0660732132636694,4305.39743081885,20642,0.09
2012-01-25,15193975,15194000,25,0.08,-6742,15931,22674,-0.445257430478423,3733.08619537019,13900,0.08
2012-01-26,15193975,15194000,25,0.08,-2920,98606,101526,-0.242667060003689,4639.30774871657,10980,0.08
2012-01-27,15193975,15194000,25,0.09,-485,9603,10088,-0.121088307219073,3949.78824859386,10495,0.09
2012-01-30,15252831,16394000,1141169,0.09,444,13679,13235,-0.00521836464519762,4338.1765852626,10939,0.09
2012-01-31,15313699,16394000,1080301,0.11,49618,127698,78079,2.62107319028859,4467.6733357443,60557,0.11
2012-02-01,15288345,16394000,1105655,0.11,-37904,24116,62020,-2.15794698187651,4464.11211776765,22653,0.11
2012-02-02,15308966,16394000,1085034,0.11,8384,103875,95490,0.315367058984029,4105.98665935794,31037,0.11
2012-02-03,15292677,16394000,1101323,0.11,-35177,10550,45727,-1.89362827420529,4298.44520977394,-4140,0.11
2012-02-06,15295477,16394000,1098523,0.11,-10571,13278,23849,-0.61450084627387,4697.90917247845,-14711,0.11
2012-02-07,15301110,16394000,1092890,0.11,-10830,5298,16128,-0.615155967614245,4358.01019980304,-25541,0.11
2012-02-08,15293280,16394000,1100720,0.11,-23361,10833,34194,-1.20293853248757,4473.52172790074,-48902,0.11
2012-02-09,15313400,16394000,1080600,0.11,12533,137609,125076,0.592413797863505,3874.95245674879,-36369,0.11
2012-02-10,15311676,16394000,1082324,0.12,-4587,7203,11790,-0.263337265920613,4591.39095940037,-40956,0.12
2012-02-13,15312796,16394000,1081204,0.12,8360,24479,16119,0.370229280189262,4677.96268808454,-32596,0.12
2012-02-14,15316991,16394000,1077009,0.12,-7524,6790,14314,-0.409274160387567,4573.00452309573,-40120,0.12
2012-02-15,15349347,16394000,1044653,0.12,-7853,116135,123987,-0.407395591792908,4020.4125027245,-47973,0.12
2012-02-16,15370620,16394000,1023380,0.11,20234,121242,101009,1.37720950244354,4324.7744349841,-27739,0.11
2012-02-17,15374192,16394000,1019808,0.09,-12952,8753,21705,-0.731233777869399,4246.18957503582,-40691,0.09
2012-02-21,15377436,16394000,1016564,0.1,-2506,17806,20312,-0.0740434419615163,4603.22130574694,-43197,0.1
2012-02-22,15373968,16394000,1020032,0.08,-18807,8219,27026,-1.07530023155101,4510.91263810013,-62004,0.08
2012-02-23,15393320,16394000,1000680,0.08,7822,123760,115938,0.578635651689489,4213.8267668983,-54182,0.08
2012-02-24,15395623,16394000,998377,0.09,-7512,7552,15064,-0.364228062601118,4224.62768905274,-61694,0.09
2012-02-27,15396182,16394000,997818,0.1,-1044,16372,17416,0.0257257763574786,4202.4939363336,-62738,0.1
2012-02-28,15399794,16394000,994206,0.1,-9705,5053,14758,-0.501705484346141,4273.14341491652,-72443,0.1
2012-02-29,15446261,16394000,947739,0.1,36948,126325,89377,2.19704883421938,4132.90714267814,-35495,0.1
2012-03-01,15458356,16394000,935644,0.11,-716,147421,148137,-0.00295208860409978,3752.94005340406,-36211,0.11
2012-03-02,15447224,16394000,946776,0.11,-26315,10877,37192,-1.42620412275824,3955.29098642585,-62526,0.11
2012-03-05,15449364,16394000,944636,0.11,468,15990,15522,0.0972469641280714,4667.83214595996,-62058,0.11
2012-03-06,15456414,16394000,937586,0.11,-8012,5849,13862,-0.381530641863967,4323.80468802173,-70070,0.11
2012-03-07,15455707,16394000,938293,0.11,-1530,14924,16454,-0.00960068696382532,4146.9334575789,-71600,0.11
2012-03-08,15475131,16394000,918869,0.11,13442,148860,135418,0.808215042263976,3800.35489435077,-58158,0.11
2012-03-09,15474398,16394000,919602,0.12,-4126,8045,12171,-0.190631580566058,4392.58470850917,-62284,0.12
2012-03-12,15476517,16394000,917483,0.12,14618,27300,12682,0.840672793031664,4687.70222116185,-47666,0.12
2012-03-13,15481564,16394000,912436,0.12,-593,11715,12309,-0.0115446271692712,4249.63096735824,-48259,0.12
2012-03-14,15473846,16394000,920154,0.13,-4358,21818,26176,-0.16721434524677,4546.25395164603,-52617,0.13
2012-03-15,15522183,16394000,871817,0.14,55663,208246,152583,3.01857852895965,3492.23501761465,3046,0.14
2012-03-16,15523954,16394000,870046,0.15,6501,21885,15385,0.357946188786876,4067.91208047131,9547,0.15
2012-03-19,15531651,16394000,862349,0.15,20,13812,13792,-0.000174410024478278,4326.11742377455,9567,0.15
2012-03-20,15540807,16394000,853193,0.15,-8798,5041,13840,-0.45349742548529,3823.937899123,769,0.15
2012-03-21,15531862,16394000,862138,0.15,-11633,13555,25188,-0.584305096359225,4295.91163413006,-10864,0.15
2012-03-22,15542314,16394000,851686,0.14,3787,118396,114609,0.232432410154296,3884.14543184396,-7077,0.14
2012-03-23,15542995,16394000,851005,0.14,-4775,7769,12544,-0.226548501764833,4063.67686387196,-11852,0.14
2012-03-26,15543524,16394000,850476,0.14,1864,13151,11286,0.128010176163054,4122.5802699935,-9988,0.14
2012-03-27,15546867,16394000,847133,0.14,-5762,5309,11071,-0.274217188271491,4258.96790724239,-15750,0.14
2012-03-28,15537682,16394000,856318,0.13,-13834,11851,25685,-0.68933801698629,3992.82996221262,-29584,0.13
2012-03-29,15537303,16394000,856697,0.13,-4422,106246,110668,-0.190454538350401,3914.686432333,-34006,0.13
2012-03-30,15538685,16394000,855315,0.09,-20550,29832,50382,-1.15193898085926,3711.12869623245,-54556,0.09
2012-04-02,15576953,16394000,817047,0.15,36131,129958,93827,2.25540236806465,4269.62562092476,-18425,0.15
2012-04-03,15573484,16394000,820516,0.15,-26175,9260,35436,-1.53059649824796,4570.83061770115,-44600,0.15
2012-04-04,15574371,16394000,819629,0.15,3338,17980,14641,0.225529650579246,4298.96319061768,-41262,0.15
2012-04-05,15576322,16394000,817678,0.15,-8502,128873,137375,-0.524222254267334,4145.21412241092,-49764,0.15
2012-04-06,15575233,16394000,818767,0.12,-2100,8898,10998,-0.106699091911601,4448.03732239609,-51864,0.12
2012-04-09,15578070,16394000,815930,0.16,2602,12900,10297,0.175132492533679,4592.66594812981,-49262,0.16
2012-04-10,15583467,16394000,810533,0.15,-2839,8603,11442,-0.147077981192266,4482.18918689772,-52101,0.15
2012-04-11,15574733,16394000,819267,0.16,-10411,13985,24396,-0.614688960470165,4604.31043481635,-62512,0.16
2012-04-12,15571619,16394000,822381,0.15,-11959,102808,114767,-0.702204641657719,4726.183511054,-74471,0.15
2012-04-13,15572361,16394000,821639,0.15,2486,20354,17867,0.228260209770985,4244.80216900249,-71985,0.15
2012-04-16,15611306,16394000,782694,0.15,39078,110554,71476,2.30841643029452,4676.81591410699,-32907,0.15
2012-04-17,15618252,16394000,775748,0.16,38914,50605,11691,2.10370107473042,3835.25387117322,6007,0.16
2012-04-18,15617425,16394000,776575,0.15,-951,24049,25000,-0.149110850974796,4426.70725840181,5056,0.15
2012-04-19,15572263,16394000,821737,0.13,-43540,111123,154664,-2.31458118219193,4520.73329667683,-38484,0.13
2012-04-20,15574041,16394000,819959,0.12,6245,17577,11332,0.290562914051779,4326.27469012827,-32239,0.12
2012-04-23,15576888,16394000,817112,0.13,15791,28135,12344,0.765995358104066,4384.71376018209,-16448,0.13
2012-04-24,15584991,16394000,809009,0.14,26776,39879,13103,1.27090829165476,4316.37360689337,10328,0.14
2012-04-25,15580021,16394000,813979,0.15,-5772,21748,27519,-0.363537473240623,4465.78396430828,4556,0.15
2012-04-26,15581067,16394000,812933,0.14,-2079,103985,106064,-0.163457471336974,4852.24315496664,2477,0.14
2012-04-27,15580428,16394000,813572,0.13,2621,16387,13766,0.0513923109658758,3584.578990023,5098,0.13
2012-04-30,15649863,16394000,744137,0.16,63486,144756,81271,2.92771403955672,3567.12876534776,68584,0.16
2012-05-01,15630735,16394000,763265,0.16,-34665,25266,59930,-1.74459179741289,4056.79832503416,33919,0.16
2012-05-02,15638012,16394000,755988,0.15,4791,19734,14943,0.0952244481035436,4154.95726946874,38710,0.15
2012-05-03,15628651,16394000,765349,0.15,-23633,129584,153217,-1.17460357013777,4528.64526669812,15077,0.15
2012-05-04,15629375,16394000,764625,0.16,2070,12573,10502,0.003889012704379,4869.55784660461,17147,0.16
2012-05-07,15633283,16394000,760717,0.16,2722,14340,11617,0.0479401982721118,4508.6687898258,19869,0.16
2012-05-08,15643229,16394000,750771,0.16,-4658,6413,11071,-0.28935910471761,4386.20333383147,15211,0.16
2012-05-09,15631561,16394000,762439,0.15,-10445,11440,21885,-0.548819869940089,4294.25024546019,4766,0.15
2012-05-10,15632184,16394000,761816,0.15,-599,102806,103406,-0.0317015489265263,4172.39529774384,4167,0.15
2012-05-11,15631688,16394000,762312,0.15,-5453,8016,13469,-0.26213645494801,4037.7914954974,-1286,0.15
2012-05-14,15634534,16394000,759466,0.16,4310,15620,11310,0.226140875131365,4300.39410255637,3024,0.16
2012-05-15,15673665,16394000,720335,0.16,3524,90017,86493,0.171199792105269,4131.52654250564,6548,0.16
2012-05-16,15666314,16394000,727686,0.16,-3550,17337,20887,-0.198219172232606,4485.94536222379,2998,0.16
2012-05-17,15670365,16394000,723635,0.16,-8847,98093,106940,-0.450586664374767,4169.95194902086,-5849,0.16
2012-05-18,15669759,16394000,724241,0.16,-1328,8724,10052,-0.073386706958107,4952.68519825517,-7177,0.16
2012-05-21,15673047,16394000,720953,0.16,3479,12608,9129,0.16866948351786,4028.0693034619,-3698,0.16
2012-05-22,15678815,16394000,715185,0.16,-3227,6715,9942,-0.175198644015934,4029.3069831282,-6925,0.16
2012-05-23,15671905,16394000,722095,0.15,-10746,10688,21434,-0.562661876128676,4657.50011928192,-17671,0.15
2012-05-24,15670038,16394000,723962,0.15,-8468,94894,103362,-0.440655299442524,4515.06176186905,-26139,0.15
2012-05-25,15669203,16394000,724797,0.15,-5692,8604,14297,-0.322690755075054,4287.89770102371,-31831,0.15
2012-05-29,15671302,16394000,722698,0.16,4107,16516,12410,0.234109742251702,4189.88669117921,-27724,0.16
2012-05-30,15674283,16394000,719717,0.16,-2717,9311,12029,-0.170050443584632,4574.24059054164,-30441,0.16
2012-05-31,15729949,16394000,664051,0.16,44774,242541,197767,2.23915540845496,4436.3725296044,14333,0.16
2012-06-01,15684182,16394000,709818,0.16,-61261,18680,79941,-2.82377671038064,3996.73122420953,-46928,0.16
2012-06-04,15687421,16394000,706579,0.17,4751,14338,9588,0.207500119483497,4462.19320505134,-42177,0.17
2012-06-05,15692729,16394000,701271,0.17,-6109,5098,11207,-0.282012899122091,3735.24357209234,-48286,0.17
2012-06-07,15692683,16394000,701317,0.16,-8312,96591,104903,-0.37639813968917,4311.8539716711,-56598,0.16
2012-06-08,15694692,16394000,699308,0.17,-3798,8881,12680,-0.177222555940364,4741.80640651065,-60396,0.17
2012-06-11,15697271,16394000,696729,0.17,2084,13522,11437,0.0776229680653081,4687.94620775723,-58312,0.17
2012-06-12,15703733,16394000,690267,0.16,-2605,6571,9177,-0.133129678237794,4106.56993315261,-60917,0.16
2012-06-13,15694566,16394000,699434,0.17,-5162,15075,20237,-0.209077190803653,3918.37936160201,-66079,0.17
2012-06-14,15696338,16394000,697662,0.17,2544,110526,107982,0.217305893051714,4350.0681326538,-63535,0.17
2012-06-15,15731556,16394000,662444,0.18,79351,132787,53436,3.3634015829804,3796.04073773447,15816,0.18
2012-06-18,15735551,16394000,658449,0.17,12199,22521,10322,0.468737076862402,4205.88456722925,28015,0.17
2012-06-19,15744099,16394000,649901,0.17,9433,19953,10520,0.341801611314634,4498.78447383996,37448,0.17
2012-06-20,15737388,16394000,656612,0.16,104,21179,21075,-0.0556594914048497,4441.14792423317,37552,0.16
2012-06-21,15739059,16394000,654941,0.17,-6004,98789,104793,-0.296636928025708,4508.06571364831,31548,0.17
2012-06-22,15737866,16394000,656134,0.17,-3583,10329,13912,-0.189333365720845,4137.82885356905,27965,0.17
2012-06-25,15742031,16394000,651969,0.17,3517,13592,10075,0.12681299658562,4393.66585227286,31482,0.17
2012-06-26,15748576,16394000,645424,0.16,-6255,4739,10993,-0.306623352041273,4925.27598541845,25227,0.16
2012-06-27,15738433,16394000,655567,0.15,-9633,11396,21028,-0.424370729911893,4283.4038030149,15594,0.15
2012-06-28,15740413,16394000,653587,0.15,-5813,125644,131457,-0.276583137569555,4508.28583717609,9781,0.15
2012-06-29,15815885,16394000,578115,0.09,-20691,25925,46616,-1.01954518204574,4596.00609397692,-10910,0.09
2012-07-02,15849602,16394000,544398,0.18,32996,127565,94569,1.68567232803787,4295.18982118369,22086,0.18
2012-07-03,15841858,16394000,552142,0.17,-26907,6536,33443,-1.32240395848208,3987.850651846,-4821,0.17
2012-07-05,15837517,16394000,556483,0.17,-3815,100282,104097,-0.155655597263906,4620.54644847768,-8636,0.17
2012-07-06,15840404,16394000,553596,0.17,-5726,7565,13291,-0.250119671275006,4275.83525340789,-14362,0.17
2012-07-09,15840173,16394000,553827,0.17,-455,13411,13866,0.00173962860871368,4268.43981189589,-14817,0.17
2012-07-10,15846776,16394000,547224,0.17,-3106,6149,9255,-0.128463172518728,4470.11516727815,-17923,0.17
2012-07-11,15837390,16394000,556610,0.17,-9120,12008,21129,-0.425701353204057,4455.7291049108,-27043,0.17
2012-07-12,15832428,16394000,561572,0.18,-12652,92129,104781,-0.579690238395782,4410.88684627422,-39695,0.18
2012-07-13,15832094,16394000,561906,0.19,-2493,10367,12860,-0.0638247186679085,3897.82310999683,-42188,0.19
2012-07-16,15836696,16394000,557304,0.18,12222,95051,82829,0.64975427961924,4373.63706625294,-29966,0.18
2012-07-17,15845129,16394000,548871,0.17,-5310,4558,9868,-0.228145394855068,4877.08274133964,-35276,0.17
2012-07-18,15835031,16394000,558969,0.16,-8384,10680,19064,-0.371989361385213,4921.75273141656,-43660,0.16
2012-07-19,15835334,16394000,558666,0.13,-7850,91983,99833,-0.331034215496533,4993.31845847807,-51510,0.13
2012-07-20,15835857,16394000,558143,0.13,-4633,7749,12382,-0.169216876472332,4081.56538558742,-56143,0.13
2012-07-23,15838249,16394000,555751,0.14,2271,13580,11309,0.158366189218943,3755.90247434959,-53872,0.14
2012-07-24,15843518,16394000,550482,0.15,-5800,5370,11170,-0.247668032060641,4376.55603557634,-59672,0.15
2012-07-25,15835897,16394000,558103,0.15,-4400,15372,19771,-0.179460205249286,4382.69673912568,-64072,0.15
2012-07-26,15840533,16394000,553467,0.14,-7490,117807,125297,-0.319102953959129,4767.3337828209,-71562,0.14
2012-07-27,15839363,16394000,554637,0.14,-1461,9881,11342,-0.0197869274572405,4238.05401987715,-73023,0.14
2012-07-30,15834791,16394000,559209,0.14,3547,12971,9424,0.302882190767938,4095.12990462016,-69476,0.14
2012-07-31,15894576,16394000,499424,0.13,57630,128336,70706,3.07938466180357,4207.30294523889,-11846,0.13
2012-08-01,15868492,16394000,525508,0.14,-37802,23895,61696,-1.93862322296099,3805.56620237185,-49648,0.14
2012-08-02,15881924,16394000,512076,0.14,6310,104318,98008,0.318795532671492,4392.19880746372,-43338,0.14
2012-08-03,15865974,16394000,528026,0.14,-25033,10855,35888,-1.25143080058045,4534.76471686256,-68371,0.14
2012-08-06,15870080,16394000,523920,0.14,1228,12848,11620,0.070676770809864,4670.8289859374,-67143,0.14
2012-08-07,15873454,16394000,520546,0.13,-8006,4588,12593,-0.383155836174382,4326.43925919365,-75149,0.13
2012-08-08,15865345,16394000,528655,0.13,-1070,19270,20340,-0.0347311621133196,4109.33461033323,-76219,0.13
2012-08-09,15877200,16394000,516800,0.13,4680,106022,101342,0.243335000720858,4482.3061524671,-71539,0.13
2012-08-10,15876371,16394000,517629,0.13,-1623,7462,9085,-0.0698489800927923,4502.06405678868,-73162,0.13
2012-08-13,15876980,16394000,517020,0.13,2443,12290,9847,0.306673988885378,4619.27436856304,-70719,0.13
2012-08-14,15880933,16394000,513067,0.13,-2644,7364,10009,-0.00738269198349482,4495.61649532251,-73363,0.13
2012-08-15,15906325,16394000,487675,0.13,-9062,112877,121939,-0.411361624747341,4398.02848435596,-82425,0.13
2012-08-16,15919394,16394000,474606,0.13,11102,112242,101140,0.927458267105377,4298.022709192,-71323,0.13
2012-08-17,15923501,16394000,470499,0.13,-6000,7289,13289,-0.2199398852997,4444.88332082118,-77323,0.13
2012-08-20,15926250,16394000,467750,0.13,2127,14174,12048,0.315333383067397,4018.67762296276,-75196,0.13
2012-08-21,15931629,16394000,462371,0.13,-5714,4997,10711,-0.194930615801627,4148.27915698615,-80910,0.13
2012-08-22,15921975,16394000,472025,0.13,-7740,13868,21607,-0.328189762503357,4053.06642291629,-88650,0.13
2012-08-23,15937955,16394000,456045,0.13,14160,141548,127389,1.08653807732101,4072.43027437948,-74490,0.13
2012-08-24,15936258,16394000,457742,0.13,-3463,6805,10268,-0.0841089115704012,4186.0719679235,-77953,0.13
2012-08-27,15936707,16394000,457293,0.13,3801,13656,9855,0.363161803062448,4203.74659527684,-74152,0.13
2012-08-28,15940415,16394000,453585,0.13,-5990,4998,10988,-0.250139537121384,4012.71557933464,-80142,0.13
2012-08-29,15939693,16394000,454307,0.13,2833,13191,10358,0.352686186086655,3804.89169568242,-77309,0.13
2012-08-30,15952028,16394000,441972,0.14,8913,140538,131625,0.78397664669842,4269.36746030499,-68396,0.14
2012-08-31,15976711,16394000,417289,0.13,-3814,124743,128556,-0.178534302026422,4510.35646666083,-72210,0.13
2012-09-04,15969050,16394000,424950,0.14,-764,25538,26302,0.0520229505867627,4331.29168048385,-72974,0.14
2012-09-05,15981683,16394000,412317,0.16,-2795,9384,12179,-0.101715304131752,4263.72050393952,-75769,0.16
2012-09-06,16006495,16394000,387505,0.16,24170,147013,122843,1.79584068263155,4611.82980617359,-51599,0.16
2012-09-07,16007675,16394000,386325,0.15,-3230,7075,10305,-0.208609871739983,4292.56110577653,-54829,0.15
2012-09-10,16009050,16394000,384950,0.15,3589,13294,9705,0.278906958221407,4632.39814363048,-51240,0.15
2012-09-11,16015998,16394000,378002,0.15,-4767,6179,10946,-0.303848249146073,4638.3440588997,-56007,0.15
2012-09-12,16007394,16394000,386606,0.15,-7841,13938,21778,-0.525012026969368,4279.88573575406,-63848,0.15
2012-09-13,16006718,16394000,387282,0.15,-4796,108116,112912,-0.308212477763888,4326.56759911163,-68644,0.15
2012-09-14,16006835,16394000,387165,0.16,29635,46515,16881,2.05091170398024,3784.83068334467,-39009,0.16
2012-09-17,15970028,16394000,423972,0.16,10908,131827,120919,0.710274858754335,4398.25293986327,-28101,0.16
2012-09-18,15982077,16394000,411923,0.16,5222,15445,10224,0.309126652963679,4703.18532410293,-22879,0.16
2012-09-19,15974085,16394000,419915,0.15,-3775,17701,21476,-0.32023014047407,4475.41363336201,-26654,0.15
2012-09-20,15975476,16394000,418524,0.16,-2852,135594,138447,-0.258898103957633,4494.4458249061,-29506,0.16
2012-09-21,15977166,16394000,416834,0.15,215,11994,11778,-0.058905381755777,4647.85020547561,-29291,0.15
2012-09-24,15978942,16394000,415058,0.16,6622,18056,11434,0.374759562809749,4258.14160550582,-22669,0.16
2012-09-25,15983855,16394000,410145,0.15,-4255,10136,14391,-0.371111624624731,3850.2147641604,-26924,0.15
2012-09-26,15976962,16394000,417038,0.15,-9741,13644,23385,-0.820877061956867,4333.10829049343,-36665,0.15
2012-09-27,15976237,16394000,417763,0.14,-4042,107029,111071,-0.455822666442009,4986.15220377461,-40707,0.14
2012-09-28,16027021,16394000,366979,0.09,23823,38389,14566,2.30806103521345,4222.09716593205,-16884,0.09
2012-10-01,16120279,16394000,273721,0.15,11203,126454,115251,1.04036323038202,4515.24821339552,-5681,0.15
2012-10-02,16131841,16394000,262159,0.16,-1668,7490,9158,-0.340973615500935,4524.70833015962,-7349,0.16
2012-10-03,16114134,16394000,279866,0.16,-21493,12062,33556,-2.29791335558951,4451.27449084609,-28842,0.16
2012-10-04,16122679,16394000,271321,0.15,-3510,105617,109127,-0.466322702000769,4897.68821745493,-32352,0.15
2012-10-05,16122677,16394000,271323,0.15,-2968,7399,10367,-0.391988360844346,4804.59318496539,-35320,0.15
2012-10-09,16128791,16394000,265209,0.16,2437,14175,11738,0.144800642979705,4606.06804910825,-32883,0.16
2012-10-10,16118625,16394000,275375,0.16,-15995,8043,24038,-1.61675832837852,4488.39090082085,-48878,0.16
2012-10-11,16119122,16394000,274878,0.16,-2780,109766,112546,-0.324725884285319,4358.21868910493,-51658,0.16
2012-10-12,16118406,16394000,275594,0.16,-5396,8426,13821,-0.593529801193276,4541.41940541424,-57054,0.16
2012-10-15,16151879,16394000,242121,0.16,31455,89381,57927,2.71653283812173,4131.8960027786,-25599,0.16
2012-10-16,16160486,16394000,233514,0.16,749,11412,10663,-0.0507123159468664,4463.58222242508,-24850,0.16
2012-10-17,16154024,16394000,239976,0.15,-8880,12534,21413,-0.884347926825057,4571.67320928997,-33730,0.15
2012-10-18,16159031,16394000,234969,0.15,-3100,131861,134960,-0.37582501348287,4755.4222111553,-36830,0.15
2012-10-19,16156921,16394000,237079,0.16,-2211,9906,12117,-0.310850485255686,4527.84122244964,-39041,0.16
2012-10-22,16159583,16394000,234417,0.15,3461,14162,10701,0.228060033612818,4575.25265153705,-35580,0.15
2012-10-23,16164763,16394000,229237,0.15,-2546,8347,10893,-0.324867532087304,4347.70523014774,-38126,0.15
2012-10-24,16155722,16394000,238278,0.17,-11357,10729,22086,-1.08221110471206,5071.92579835,-49483,0.17
2012-10-25,16157991,16394000,236009,0.16,-5474,107050,112524,-0.552038110843052,4524.62162550287,-54957,0.16
2012-10-26,16158737,16394000,235263,0.16,-1814,10609,12422,-0.210491866145422,4691.86192268989,-56771,0.16
2012-10-29,16159952,16394000,234048,0.17,4216,15595,11379,0.347572294453734,4326.88949716016,-52555,0.17
2012-10-30,16165032,16394000,228968,0.17,-6232,5218,11450,-0.595925158734843,4106.46915679569,-58787,0.17
2012-10-31,16222235,16394000,171765,0.18,56423,122065,65643,3.86496114914587,4416.18108552613,-2364,0.18
2012-11-01,16182427,16394000,211573,0.17,-53238,102866,156104,-3.23841346422169,4618.90791737683,-55602,0.17
2012-11-02,16166883,16394000,227117,0.16,-21211,11377,32588,-1.24831833742423,4685.74563225094,-76813,0.16
2012-11-05,16170751,16394000,223249,0.17,1626,13162,11536,0.129509074909955,4548.76257820269,-75187,0.17
2012-11-06,16175163,16394000,218837,0.16,-5518,5155,10673,-0.28995981628083,4853.87081828873,-80705,0.16
2012-11-07,16174798,16394000,219202,0.16,2345,12268,9923,0.176164976850726,4044.54663537389,-78360,0.16
2012-11-08,16206110,16394000,187890,0.16,20722,131251,110529,1.22595656037208,4499.21216198697,-57638,0.16
2012-11-09,16205513,16394000,188487,0.16,-5069,7634,12703,-0.310964429640732,4727.79472300323,-62707,0.16
2012-11-13,16209147,16394000,184853,0.16,991,14505,13514,0.0969062511878653,4777.55570366137,-61716,0.16
2012-11-14,16205250,16394000,188750,0.16,-13754,9587,23341,-0.780447657834548,4283.69150800035,-75470,0.16
2012-11-15,16239726,16394000,154274,0.16,-3485,236767,240252,-0.129579369126307,4526.27185984297,-78955,0.16
2012-11-16,16242136,16394000,151864,0.16,3393,13592,10198,0.286891222627505,4285.76078779004,-75562,0.16
2012-11-19,16246955,16394000,147045,0.16,1539,12973,11434,0.16479512384456,4428.47175581639,-74023,0.16
2012-11-20,16253547,16394000,140453,0.16,-4894,6937,11832,-0.22689196031044,4179.4487579865,-78917,0.16
2012-11-21,16244032,16394000,149968,0.16,-7773,14134,21907,-0.383804708925842,4512.69408147903,-86690,0.16
2012-11-23,16268351,16394000,125649,0.16,17874,130380,112506,1.1560797886495,4572.4195362929,-68816,0.16
2012-11-26,16270639,16394000,123361,0.16,2521,13427,10906,0.199929279340088,4327.1107178215,-66295,0.16
2012-11-27,16278595,16394000,115405,0.16,-9020,5789,14809,-0.498481832562042,3917.21968730009,-75315,0.16
2012-11-28,16267639,16394000,126361,0.16,-10911,10565,21476,-0.576058022536912,4023.8321535571,-86226,0.16
2012-11-29,16283989,16394000,110011,0.16,10504,107575,97071,0.769918996306867,4037.24148398384,-75722,0.16
2012-11-30,16330896,16394000,63104,0.16,22340,123257,100917,1.43527335176377,3944.4775935115,-53382,0.16
2012-12-03,16299478,16394000,94522,0.16,-24964,25390,50354,-1.4391691627785,4459.06637560639,-78346,0.16
2012-12-04,16308454,16394000,85546,0.17,-4861,6172,11033,-0.217654124140039,4238.54626995385,-83207,0.17
2012-12-05,16299340,16394000,94660,0.16,2310,12605,10296,0.209062063011929,4484.02981561247,-80897,0.16
2012-12-06,16327831,16394000,66169,0.16,21981,131179,109198,1.33972880370891,4198.83352509105,-58916,0.16
2012-12-07,16326778,16394000,67222,0.16,-3934,8312,12246,-0.214412889714733,4290.81004969221,-62850,0.16
2012-12-10,16331502,16394000,62498,0.16,2131,13987,11856,0.141013775177856,4477.5174040944,-60719,0.16
2012-12-11,16337333,16394000,56667,0.17,-3597,7711,11308,-0.204437725506324,4195.46758920427,-64316,0.17
2012-12-12,16327894,16394000,66106,0.17,-6612,13824,20436,-0.34405555005673,3990.40400468861,-70928,0.17
2012-12-13,16331400,16394000,62600,0.16,-2413,134708,137120,-0.0754112217225492,4465.79278054078,-73341,0.16
2012-12-14,16321006,16394000,72994,0.17,9819,42568,32749,0.661647244494608,3898.68121159996,-63522,0.17
2012-12-17,16312661,16394000,81339,0.16,45339,132773,87434,2.55803680044436,4440.50734410111,-18183,0.16
2012-12-18,16321239,16394000,72761,0.17,-3809,6423,10232,-0.241323762791414,4852.41449243047,-21992,0.17
2012-12-19,16313537,16394000,80463,0.17,-5319,15979,21298,-0.314570407104879,4539.56162863318,-27311,0.17
2012-12-20,16295706,16394000,98294,0.17,-25218,111381,136599,-1.37969074621118,4199.06000620547,-52529,0.17
2012-12-21,16297719,16394000,96281,0.17,2298,18835,16538,0.129190117968635,4089.10944189291,-50231,0.17
2012-12-24,16299095,16394000,94905,0.18,11488,22434,10946,0.615682327994507,4244.63034333819,-38743,0.18
2012-12-26,16299423,16394000,94577,0.17,-7907,8617,16524,-0.452189577651925,4710.43947693557,-46650,0.17
2012-12-27,16299792,16394000,94208,0.17,-930,115344,116274,-0.0584628830238185,4040.6970060182,-47580,0.17
2012-12-28,16298022,16394000,95978,0.17,4017,18479,14463,0.201852674948237,4352.47868479414,-43563,0.17
2012-12-31,16393975,16394000,25,0.09,33955,144499,110545,2.06755459818369,3995.52499043697,-9608,0.09
2013-01-02,16393975,16394000,25,0.17,-8262,31675,39938,-0.64963162027649,3980.91312838076,-17870,0.17
2013-01-03,16392475,16394000,1525,0.17,-21668,114416,136085,-1.59282783134271,4224.01864051247,-39538,0.17
2013-01-04,16393975,16394000,25,0.16,-676,14138,14814,-0.109252414350885,4334.28832507952,-40214,0.16
2013-01-07,16393975,16394000,25,0.16,1757,14440,12683,0.0495165428915592,4658.95488893624,-38457,0.16
2013-01-08,16393975,16394000,25,0.15,-6702,7035,13737,-0.530277947015647,4111.42123758405,-45159,0.15
2013-01-09,16393975,16394000,25,0.14,-9830,10757,20587,-0.710652627680634,4347.83446991462,-54989,0.14
2013-01-10,16393975,16394000,25,0.14,-4701,131290,135991,-0.343080094109465,4745.70646253763,-59690,0.14
2013-01-11,16393975,16394000,25,0.14,1034,10630,9597,0.0687747510076949,4532.32269371897,-58656,0.14
2013-01-14,16393975,16394000,25,0.14,6603,18424,11821,0.436846898182686,4334.73187834529,-52053,0.14
2013-01-15,16393975,16394000,25,0.15,26764,88151,61387,1.76991892269988,4415.57710720609,-25289,0.15
2013-01-16,16393975,16394000,25,0.14,139,21438,21298,-0.0780802493135832,4664.86581409284,-25150,0.14
2013-01-17,16393975,16394000,25,0.14,-7743,104688,112431,-0.607803282238927,4576.63799248812,-32893,0.14
2013-01-18,16393975,16394000,25,0.14,-425,15006,15431,-0.108668930674364,4445.5612878787,-33318,0.14
2013-01-22,16393975,16394000,25,0.14,9729,23288,13558,0.566490052074556,4850.38941481989,-23589,0.14
2013-01-23,16393975,16394000,25,0.13,2504,26888,24384,0.0926551650716988,4204.05725451097,-21085,0.13
2013-01-24,16393975,16394000,25,0.15,-11456,102297,113752,-0.861057919832899,4754.19599223041,-32541,0.15
2013-01-25,16393975,16394000,25,0.14,250,11061,10811,-0.0581598269550332,4294.38965885299,-32291,0.14
2013-01-28,16393975,16394000,25,0.14,5419,15834,10415,0.279562151670241,4294.60399739539,-26872,0.14
